varname	groupname
Abies	Trees and shrubs
Abies undiff.	Trees and shrubs
Acacia	Trees and shrubs
Acer	Trees and shrubs
Acer cf. A. campestre	Trees and shrubs
Acer-type	Trees and shrubs
Achillea	Herbs
Achillea-type	Herbs
Aconitum	Herbs
Acorus calamus	Helophytes
Adonis	Herbs
Adoxa moschatellina	Herbs
Aellenia-type	Herbs
Aesculus	Trees and shrubs
Agrimonia	Herbs
Agrimonia-type	Herbs
Agropyron-type	Herbs
Ajuga-type	Herbs
Alchemilla	Herbs
Alchemilla cf. A. glabra	Herbs
Alchemilla-type	Herbs
Aldrovanda vesiculosa	Aquatics
Alisma	Helophytes
Alisma gramineum	Helophytes
Alisma plantago-aquatica	Helophytes
Alisma plantago-aquatica-type	Helophytes
Alisma-type	Helophytes
Allium	Herbs
Allium oleraceum-type	Herbs
Allium ursinum-type	Herbs
Allium-type	Herbs
Alnus	Trees and shrubs
Alnus glutinosa	Trees and shrubs
Alnus undiff.	Trees and shrubs
Alnus viridis	Trees and shrubs
Ambrosia-type	Herbs
Ambrosia/Xanthium	Herbs
Anagallis	Herbs
Anagallis arvensis-type	Herbs
Anagallis tenella-type	Herbs
Anchusa	Herbs
Anchusa arvensis	Herbs
Anchusa officinalis	Herbs
Anchusa-type	Herbs
Andromeda polifolia	Dwarf shrubs
Anemone-type	Herbs
Angelica-type	Herbs
Anthemis-type	Herbs
Anthericum	Herbs
Anthriscus	Herbs
Anthyllis	Herbs
Anthyllis vulneraria	Herbs
Apium	Herbs
Arbutus	Trees and shrubs
Arctium	Herbs
Arctium-type	Herbs
Arctostaphylos alpinus	Dwarf shrubs
Arctostaphylos uva-ursi	Dwarf shrubs
Arenaria-type	Herbs
Armeria	Herbs
Armeria (type A)	Herbs
Armeria (type B)	Herbs
Armeria maritima	Herbs
Armeria maritima-type	Herbs
Armeria-type	Herbs
Artemisia	Herbs
Artemisia cf. A. norvegica	Herbs
Artemisia cf. A. norvegica (type 1)	Herbs
Artemisia cf. A. norvegica (type 2)	Herbs
Artemisia norvegica	Herbs
Artemisia undiff.	Herbs
Artemisia vulgaris-type	Herbs
Artemisia-type	Herbs
Aruncus dioicus	Herbs
Asclepiadaceae	Indeterminables and unknowns
Asparagus	Herbs
Asparagus-type	Herbs
Asphodelus	Herbs
Aster	Herbs
Aster-type	Herbs
Astragalus	Herbs
Astragalus alpinus	Herbs
Astragalus frigidus	Herbs
Astragalus penduliflorus	Herbs
Astragalus undiff.	Herbs
Astragalus-type	Herbs
Atropa	Herbs
Avena	Herbs
Avena-type	Herbs
Baldellia	Helophytes
Bartsia	Herbs
Bellis-type	Herbs
Berberis	Trees and shrubs
Berberis-type	Trees and shrubs
Betula	Trees and shrubs
Betula (excl. B. nana)	Trees and shrubs
Betula cf. B. nana	Dwarf shrubs
Betula nana	Dwarf shrubs
Betula undiff.	Trees and shrubs
Betula/Corylus	Trees and shrubs
Noaea-type	Herbs
Betula/Corylus/Myrica	Trees and shrubs
Bidens	Herbs
Bidens-type	Herbs
Bilderdykia convolvulus	Herbs
Bilderdykia convolvulus-type	Herbs
Blackstonia	Herbs
Blackstonia-type	Herbs
Boraginaceae	Herbs
Borago	Herbs
Borago officinalis	Herbs
Brasenia schreberi	Pre-Quaternary type
Brassica	Herbs
Bruckenthalia spiculifolia	Dwarf shrubs
Buglossoides arvensis	Herbs
Bunium	Herbs
Bupleurum	Herbs
Bupleurum-type	Herbs
Butomus umbellatus	Helophytes
Buxus	Trees and shrubs
Buxus sempervirens	Trees and shrubs
Calla	Helophytes
Callitriche	Aquatics
Polygonum (pericolpate/periporate)	Herbs
Calluna vulgaris	Dwarf shrubs
Caltha	Helophytes
Caltha-type	Helophytes
Calicotome	Trees and shrubs
Calystegia	Herbs
Campanula	Herbs
Campanula-type	Herbs
Campanulaceae	Herbs
Cannabis	Herbs
Cannabis-type	Herbs
Capparis spinosa	Trees and shrubs
Cardamine-type	Herbs
Carpinus	Trees and shrubs
Carpinus betulus	Trees and shrubs
Carpinus orientalis-type	Trees and shrubs
Carpinus orientalis/Ostrya	Trees and shrubs
Carya	Trees and shrubs
Caryophyllaceae	Herbs
Caryophyllaceae undiff.	Herbs
Cassia	Trees and shrubs
Cassiope	Dwarf shrubs
Castanea	Trees and shrubs
Castanea sativa	Trees and shrubs
Castanea-type	Trees and shrubs
Cedrus	Trees and shrubs
Celtis	Trees and shrubs
Centaurea	Herbs
Centaurea cyanus	Herbs
Centaurea cyanus-type	Herbs
Centaurea jacea-type	Herbs
Centaurea montana	Herbs
Centaurea montana-type	Herbs
Centaurea nigra	Herbs
Centaurea nigra-type	Herbs
Centaurea scabiosa	Herbs
Centaurea scabiosa-type	Herbs
Centaurea solstitialis-type	Herbs
Centaurium	Herbs
Cerastium alpinum-type	Herbs
Cerastium-type	Herbs
Cercis siliquastrum	Trees and shrubs
Cerealia-type	Herbs
cf. Ambrosia	Indeterminables and unknowns
cf. Avena	Herbs
cf. Bruckenthalia spiculifolia	Indeterminables and unknowns
cf. Dryas	Indeterminables and unknowns
cf. Hordeum	Herbs
cf. Origanum	Indeterminables and unknowns
cf. Oxyria digyna	Herbs
cf. Papaver	Indeterminables and unknowns
cf. Parthenocissus	Indeterminables and unknowns
cf. Pedicularis	Indeterminables and unknowns
cf. Phillyrea	Indeterminables and unknowns
cf. Rhinanthus	Indeterminables and unknowns
cf. Saussurea	Indeterminables and unknowns
cf. Scrophulariaceae	Indeterminables and unknowns
cf. Secale	Herbs
cf. Sedum	Indeterminables and unknowns
cf. Sorbus aucuparia	Trees and shrubs
Chaenorhinum	Herbs
Chamaedaphne calyculata	Dwarf shrubs
Chenopodiaceae	Herbs
Chimaphila	Dwarf shrubs
Chrysosplenium	Herbs
Cicendia filiformis	Herbs
Cicuta-type	Herbs
Circaea	Herbs
Cirsium	Herbs
Cirsium-type	Herbs
Cirsium/Carduus	Herbs
Cistaceae	Herbs
Cistaceae undiff.	Herbs
Cistus	Trees and shrubs
Citrus	Trees and shrubs
Caryophyllaceae (periporate excl. Paronychioideae)	Herbs
Cladium mariscus	Helophytes
Colchicum	Herbs
Compositae subf. Asteroideae	Herbs
Compositae subf. Asteroideae undiff.	Herbs
Compositae subf. Cichorioideae	Herbs
Compositae subf. Cichorioideae undiff.	Herbs
Conopodium-type	Herbs
Convallaria	Herbs
Convolvulaceae	Herbs
Convolvulus	Herbs
Convolvulus undiff.	Herbs
Cornus	Trees and shrubs
Cornus sanguinea	Trees and shrubs
Cornus sanguinea-type	Trees and shrubs
Cornus suecica	Trees and shrubs
Cornus suecica-type	Trees and shrubs
Coronilla emerus	Trees and shrubs
Corydalis	Herbs
Corylus	Trees and shrubs
Corylus avellana	Trees and shrubs
Corylus-type	Trees and shrubs
Corylus/Myrica	Trees and shrubs
Cotinus-type	Trees and shrubs
Cotoneaster	Trees and shrubs
Cousinia-type	Herbs
Crassula aquatica	Helophytes
Crassulaceae	Herbs
Crataegus	Trees and shrubs
Crataegus-type	Trees and shrubs
Cruciferae	Herbs
Cupressaceae	Trees and shrubs
Cuscuta	Herbs
Cynoglossum	Herbs
Cynoglossum-type	Herbs
Cyperaceae	Herbs
Cyperus	Helophytes
Cytisus scoparius	Trees and shrubs
Dactylis-type	Herbs
Daphne	Dwarf shrubs
Daphne sericea	Dwarf shrubs
Datisca cannabina	Herbs
Daucus-type	Herbs
Delphinium-type	Herbs
Dianthus	Herbs
Dianthus-type	Herbs
Diapensia lapponica	Dwarf shrubs
Digitalis	Herbs
Digitalis purpurea	Herbs
Digitalis-type	Herbs
Dipsacaceae	Herbs
Dipsacus	Herbs
Dipsacus-type	Herbs
Draba-type	Herbs
Drosera	Helophytes
Drosera cf. D. rotundifolia	Helophytes
Drosera intermedia	Helophytes
Drosera rotundifolia-type	Helophytes
Droseraceae	Helophytes
Polygonum-type (tricolporate)	Herbs
Dryas octopetala	Herbs
Dryas-type	Herbs
Dulichium-type	Helophytes
Echinops	Herbs
Echium	Herbs
Echium-type	Herbs
Elatine	Aquatics
Elymus-type	Herbs
Empetrum	Dwarf shrubs
Empetrum cf. E. nigrum	Dwarf shrubs
Empetrum nigrum	Dwarf shrubs
Lythrum hyssopifolia-type	Herbs
Empetrum-type	Dwarf shrubs
Engelhardtia	Trees and shrubs
Ephedra	Trees and shrubs
Ephedra distachya	Trees and shrubs
Ephedra distachya-type	Trees and shrubs
Ephedra fragilis	Trees and shrubs
Ephedra fragilis-type	Trees and shrubs
Ephedra undiff.	Trees and shrubs
Epilobium	Herbs
Epilobium-type	Herbs
Erica	Dwarf shrubs
Erica tetralix-type	Dwarf shrubs
Ericaceae	Dwarf shrubs
Ericaceae undiff.	Dwarf shrubs
Ericaceae-type	Dwarf shrubs
Ericaceae/Empetrum	Dwarf shrubs
Ericales	Dwarf shrubs
Ericales (tetrad)	Dwarf shrubs
Ericales undiff.	Dwarf shrubs
Eriocaulon	Helophytes
Eriogonum-type	Herbs
Eriophorum	Helophytes
Eriophorum-type	Helophytes
Erodium	Herbs
Eryngium-type	Herbs
Eucalyptus	Trees and shrubs
Euonymus	Trees and shrubs
Euonymus europaeus	Trees and shrubs
Euphorbia	Herbs
Euphorbia dendroides	Herbs
Euphorbiaceae	Herbs
Euphrasia	Herbs
Fagopyrum	Herbs
Fagopyrum-type	Herbs
Fagus	Trees and shrubs
Fagus sylvatica	Trees and shrubs
Festuca-type	Herbs
Ficus	Trees and shrubs
Filago-type	Herbs
Filipendula	Herbs
Filipendula ulmaria	Herbs
Fragaria vesca	Herbs
Frangula	Trees and shrubs
Frangula alnus	Trees and shrubs
Frankenia	Herbs
Fraxinus	Trees and shrubs
Fraxinus excelsior	Trees and shrubs
Fraxinus excelsior-type	Trees and shrubs
Fraxinus ornus	Trees and shrubs
Fritillaria	Herbs
Fumaria	Herbs
Gagea lutea-type	Herbs
Gagea pratensis-type	Herbs
Galeopsis-type	Herbs
Galium	Herbs
Galium-type	Herbs
Genista-type	Trees and shrubs
Gentiana	Herbs
Gentiana cf. G. pneumonanthe	Herbs
Gentiana nivalis	Herbs
Gentiana nivalis-type	Herbs
Gentiana pneumonanthe	Herbs
Gentiana pneumonanthe-type	Herbs
Gentiana purpurea-type	Herbs
Gentiana verna	Herbs
Gentianaceae	Herbs
Gentianaceae undiff.	Herbs
Gentianella	Herbs
Gentianella amarella	Herbs
Gentianella campestris	Herbs
Geranium	Herbs
Geranium-type	Herbs
Geum	Herbs
Geum cf. G. rivale	Herbs
Geum rivale	Herbs
Geum-type	Herbs
Glaucium	Herbs
Glaux	Herbs
Gnaphalium	Herbs
Gramineae	Herbs
Gypsophila	Herbs
Gypsophila undiff.	Herbs
Hedera	Trees and shrubs
Hedera helix	Trees and shrubs
Hedysarum	Herbs
Helianthemum	Herbs
Helianthemum cf. H. canum	Herbs
Heliotropium-type	Herbs
Helleborus undiff.	Herbs
Helleborus/Chelidonium	Indeterminables and unknowns
Heracleum	Herbs
Heracleum-type	Herbs
Herniaria	Herbs
Herniaria-type	Herbs
Hippocrepis-type	Herbs
Hippophae	Trees and shrubs
Hippuris	Aquatics
Hordeum	Herbs
Hordeum-type	Herbs
Hornungia-type	Herbs
Picea abies-type	Trees and shrubs
Hottonia/Samolus	Indeterminables and unknowns
Humulus	Herbs
Humulus lupulus	Herbs
Humulus-type	Herbs
Humulus/Cannabis	Herbs
Hyacinthoides non-scripta	Herbs
Hydrocharis morsus-ranae	Aquatics
Hydrocotyle	Herbs
Hypericum	Herbs
Hypericum elodes	Herbs
Hypericum perforatum-type	Herbs
Hypericum pulchrum-type	Herbs
Hypericum undiff.	Herbs
Hypericum-type	Herbs
Ilex	Trees and shrubs
Ilex aquifolium	Trees and shrubs
Impatiens	Herbs
Iris	Herbs
Iris pseudacorus-type	Herbs
Jasione	Herbs
Jasione montana	Herbs
Juglans	Trees and shrubs
Juncaceae	Herbs
Juniperus	Trees and shrubs
Juniperus communis	Trees and shrubs
Juniperus-type	Trees and shrubs
Knautia	Herbs
Knautia-type	Herbs
Caryophyllaceae subf. Paronychioideae	Herbs
Koenigia islandica	Herbs
Labiatae	Herbs
Laburnum-type	Trees and shrubs
Lamium-type	Herbs
Larix	Trees and shrubs
Lathyrus	Herbs
Lathyrus japonicus subsp. maritimus	Herbs
Lathyrus palustris	Herbs
Lathyrus sativus	Herbs
Lathyrus-type	Herbs
Ledum	Dwarf shrubs
Leguminosae	Herbs
Leguminosae undiff.	Herbs
Lemna	Aquatics
Lemnaceae	Aquatics
Ligustrum	Trees and shrubs
Liliaceae	Herbs
Lilium	Herbs
Lilium-type	Herbs
Limosella	Herbs
Linaria	Herbs
Rosaceae (operculate)	Herbs
Linnaea borealis	Herbs
Linum	Herbs
Linum bienne-type	Herbs
Linum catharticum	Herbs
Linum catharticum-type	Herbs
Linum usitatissimum	Herbs
Linum usitatissimum-type	Herbs
Liquidambar	Trees and shrubs
Listera-type	Herbs
Lithospermum	Herbs
Lithospermum officinale	Herbs
Anthoceros/Phaeoceros	Bryophytes
Littorella uniflora	Aquatics
Lobelia	Helophytes
Lobelia-type	Helophytes
Loiseleuria procumbens	Dwarf shrubs
Lomatogonium	Herbs
Lonicera	Trees and shrubs
Lonicera periclymenum	Trees and shrubs
Lonicera xylosteum-type	Trees and shrubs
Loranthaceae	Trees and shrubs
Loranthus europaeus	Trees and shrubs
Lotus	Herbs
Lotus corniculatus	Herbs
Lotus uliginosus	Herbs
Lotus-type	Herbs
Ludwigia	Helophytes
Luronium-type	Helophytes
Luzula	Herbs
Lychnis flos-cuculi	Herbs
Lychnis-type	Herbs
Lycium	Trees and shrubs
Lycopus	Herbs
Lycopus-type	Herbs
Lysimachia	Herbs
Lysimachia nemorum	Herbs
Lysimachia thyrsiflora	Herbs
Lysimachia vulgaris	Herbs
Lysimachia-type	Herbs
Lythrum	Herbs
Lythrum portula-type	Herbs
Lythrum salicaria	Herbs
Mahonia-type	Trees and shrubs
Maianthemum bifolium	Herbs
Maianthemum-type	Herbs
Malus	Trees and shrubs
Malus-type	Trees and shrubs
Malus/Mespilus	Trees and shrubs
Malva	Herbs
Malva-type	Herbs
Malvaceae	Herbs
Marrubium	Herbs
Matricaria	Herbs
Matricaria-type	Herbs
Matthiola	Herbs
Medicago sativa	Herbs
Medicago sativa subsp. falcata	Herbs
Medicago sativa-type	Herbs
Melampyrum	Herbs
Mentha	Herbs
Mentha-type	Herbs
Rosaceae (non-operculate)	Trees and shrubs
Menyanthes trifoliata	Helophytes
Menyanthes-type	Helophytes
Mercurialis	Herbs
Mercurialis annua	Herbs
Mercurialis annua-type	Herbs
Mercurialis perennis	Herbs
Mercurialis undiff.	Herbs
Merendera-type	Herbs
Mertensia maritima	Herbs
Mespilus germanica	Trees and shrubs
Mespilus-type	Trees and shrubs
Moneses	Dwarf shrubs
Monotropa	Herbs
Montia	Herbs
Moraceae	Trees and shrubs
Muscari	Herbs
Myosotis-type	Herbs
Myrica	Trees and shrubs
Myricaria germanica	Trees and shrubs
Myriophyllum	Aquatics
Myriophyllum alterniflorum	Aquatics
Myriophyllum spicatum	Aquatics
Myriophyllum spicatum-type	Aquatics
Myriophyllum spicatum/M. verticillatum	Aquatics
Myriophyllum undiff.	Aquatics
Myriophyllum verticillatum	Aquatics
Myriophyllum verticillatum-type	Aquatics
Myrtaceae	Trees and shrubs
Myrtus	Trees and shrubs
Myrtus communis	Trees and shrubs
Myosotis	Herbs
Narcissus	Herbs
Narthecium	Herbs
Narthecium ossifragum	Herbs
Nephrophyllidium	Aquatics
Nonea	Herbs
Nuphar	Aquatics
Nuphar lutea	Aquatics
Nymphaea	Aquatics
Nymphaea cf. N. candida	Aquatics
Nymphaeaceae	Aquatics
Nymphoides peltata	Aquatics
Nyssa	Pre-Quaternary type
Odontites	Herbs
Oenothera	Herbs
Olea	Trees and shrubs
Oleaceae	Trees and shrubs
Oleaceae undiff.	Trees and shrubs
Onagraceae	Herbs
Onobrychis	Herbs
Onobrychis-type	Herbs
Ononis	Herbs
Ononis-type	Herbs
Orchidaceae	Herbs
Ornithogalum umbellatum	Herbs
Ornithogalum-type	Herbs
Ostrya	Trees and shrubs
Ostrya-type	Trees and shrubs
Ostrya/Carpinus	Trees and shrubs
Oxalis	Herbs
Oxalis acetosella	Herbs
Oxyria	Herbs
Oxyria digyna-type	Herbs
Oxyria-type	Herbs
Oxyria/Rumex subg. Acetosa	Herbs
Paliurus-type	Trees and shrubs
Papaver	Herbs
Papaver argemone	Herbs
Papaver radicatum-type	Herbs
Papaver rhoeas-type	Herbs
Parietaria	Herbs
Paris-type	Herbs
Rhinanthus-type/Veronica-type	Herbs
Parnassia palustris	Herbs
Pedicularis	Herbs
Pentaglottis sempervirens	Herbs
Penthorum sedoides	Herbs
Phillyrea	Trees and shrubs
Phragmites	Herbs
Picea	Trees and shrubs
Pimpinella-type	Herbs
Pinguicula	Herbs
Pinus	Trees and shrubs
Pinus diploxylon-type	Trees and shrubs
Pinus haploxylon-type	Trees and shrubs
Pinus sylvestris	Trees and shrubs
Pinus undiff.	Trees and shrubs
Pistacia	Trees and shrubs
Pistacia lentiscus	Trees and shrubs
Pisum	Herbs
Plantaginaceae	Herbs
Plantago	Herbs
Plantago atrata	Herbs
Plantago coronopus	Herbs
Plantago lanceolata	Herbs
Plantago lanceolata-type	Herbs
Plantago major	Herbs
Plantago major-type	Herbs
Plantago major/P. media	Herbs
Plantago maritima	Herbs
Plantago maritima-type	Herbs
Plantago maritima/P. alpina	Herbs
Plantago media	Herbs
Plantago media-type	Herbs
Plantago tenuiflora	Herbs
Plantago undiff.	Herbs
Platanus	Trees and shrubs
Platycarya	Trees and shrubs
Pleurospermum	Herbs
Pleurospermum austriacum	Herbs
Plumbaginaceae	Herbs
Podocarpaceae	Trees and shrubs
Polemonium	Herbs
Polemonium caeruleum	Herbs
Polemonium-type	Herbs
Polycnemum/Paronychia	Herbs
Polygala	Herbs
Polygalaceae	Herbs
Polygonaceae	Herbs
Polygonum	Herbs
Polygonum alpinum	Herbs
Polygonum amphibium	Aquatics
Polygonum aviculare	Herbs
Polygonum aviculare-type	Herbs
Polygonum bistorta	Herbs
Polygonum bistorta-type	Herbs
Polygonum bistorta/P. viviparum	Herbs
Polygonum cf. P. viviparum	Herbs
Polygonum oxyspermum-type	Herbs
Polygonum persicaria	Herbs
Polygonum persicaria-type	Herbs
Polygonum sect. Bistorta	Herbs
Polygonum sect. Persicaria	Herbs
Polygonum viviparum	Herbs
Polygonum viviparum-type	Herbs
Populus	Trees and shrubs
Populus balsamifera-type	Trees and shrubs
Populus tremula	Trees and shrubs
Populus tremula-type	Trees and shrubs
Potamogeton	Aquatics
Potamogeton subg. Coleogeton	Aquatics
Potamogeton subg. Potamogeton	Aquatics
Potamogeton undiff.	Aquatics
Potamogeton-type	Aquatics
Potentilla	Herbs
Potentilla palustris	Herbs
Potentilla undiff.	Herbs
Potentilla-type	Herbs
Primula	Herbs
Primula farinosa	Herbs
Primula farinosa-type	Herbs
Primula scandinavica-type	Herbs
Primula vulgaris	Herbs
Primula vulgaris-type	Herbs
Primulaceae	Herbs
Prosopis	Trees and shrubs
Prunella	Herbs
Prunella-type	Herbs
Prunus	Trees and shrubs
Prunus cf. P. padus	Trees and shrubs
Prunus dulcis-type	Trees and shrubs
Prunus padus	Trees and shrubs
Prunus-type	Trees and shrubs
Pseudotsuga	Trees and shrubs
Pterocarya	Trees and shrubs
Pulmonaria	Herbs
Pulmonaria-type	Herbs
Pyrus-type	Trees and shrubs
Pyrus/Sorbus	Trees and shrubs
Quercus	Trees and shrubs
Quercus cerris-type	Trees and shrubs
Quercus coccifera-type	Trees and shrubs
Quercus ilex-type	Trees and shrubs
Quercus pubescens-type	Trees and shrubs
Quercus robur-type	Trees and shrubs
Quercus undiff.	Trees and shrubs
Radiola	Herbs
Ranunculaceae	Herbs
Ranunculaceae undiff.	Herbs
Ranunculus	Herbs
Ranunculus acris	Herbs
Ranunculus acris-type	Herbs
Ranunculus flammula-type	Helophytes
Ranunculus sceleratus/R. repens	Herbs
Ranunculus subg. Batrachium	Aquatics
Ranunculus trichophyllus-type	Aquatics
Ranunculus undiff.	Herbs
Ranunculus-type	Herbs
Reseda	Herbs
Rhamnaceae	Trees and shrubs
Rhamnus	Trees and shrubs
Rhamnus catharticus	Trees and shrubs
Rhinanthus	Herbs
Rhinanthus-type	Herbs
Rhododendron	Trees and shrubs
Rhododendron lapponicum-type	Dwarf shrubs
Rhus	Trees and shrubs
Rhus coriaria-type	Trees and shrubs
Rhynchospora alba	Helophytes
Ribes	Trees and shrubs
Rosa	Trees and shrubs
Rosa-type	Trees and shrubs
Rosaceae	Trees and shrubs
Rosaceae undiff.	Trees and shrubs
Rubiaceae	Herbs
Rubus	Trees and shrubs
Rubus chamaemorus	Herbs
Rubus fruticosus	Trees and shrubs
Rubus saxatilis	Trees and shrubs
Rumex	Herbs
Rumex acetosa	Herbs
Rumex acetosa-type	Herbs
Rumex acetosella	Herbs
Rumex acetosella-type	Herbs
Rumex aquaticus-type	Herbs
Rumex crispus-type	Herbs
Rumex longifolius-type	Herbs
Rumex obtusifolius-type	Herbs
Rumex subg. Acetosa	Herbs
Rumex subg. Acetosa/R. subg. Acetosella	Herbs
Rumex subg. Rumex	Herbs
Rumex undiff.	Herbs
Rumex/Oxyria	Herbs
Ruppia	Aquatics
Sagina	Herbs
Sagina-type	Herbs
Sagittaria	Helophytes
Salix	Trees and shrubs
Salix herbacea	Dwarf shrubs
Salvia	Herbs
Sambucus	Trees and shrubs
Sambucus ebulus	Herbs
Sambucus nigra	Trees and shrubs
Sambucus racemosa	Trees and shrubs
Sambucus undiff.	Trees and shrubs
Sambucus-type	Trees and shrubs
Sanguisorba	Herbs
Sanguisorba minor	Herbs
Sanguisorba minor subsp. minor	Herbs
Sanguisorba officinalis	Herbs
Sarcobatus	Trees and shrubs
Satureja	Herbs
Saussurea alpina	Herbs
Saussurea-type	Herbs
Saxifraga	Herbs
Saxifraga aizoides	Herbs
Saxifraga cernua-type	Herbs
Saxifraga cespitosa-type	Herbs
Saxifraga cf. S. oppositifolia	Herbs
Saxifraga cf. S. stellaris	Herbs
Saxifraga granulata-type	Herbs
Saxifraga hirculus	Herbs
Saxifraga hirculus-type	Herbs
Saxifraga hypnoides	Herbs
Saxifraga hypnoides-type	Herbs
Saxifraga nivalis	Herbs
Saxifraga nivalis-type	Herbs
Saxifraga oppositifolia	Herbs
Saxifraga oppositifolia-type	Herbs
Saxifraga oppositifolia/S. aizoides	Herbs
Saxifraga stellaris	Herbs
Saxifraga stellaris-type	Herbs
Saxifraga undiff.	Herbs
Saxifragaceae	Herbs
Scabiosa	Herbs
Scabiosa columbaria	Herbs
Scabiosa columbaria-type	Herbs
Scabiosa rotata-type	Herbs
Scheuchzeria	Helophytes
Schoenus-type	Helophytes
Sciadopitys	Trees and shrubs
Scilla-type	Herbs
Scirpus lacustris	Helophytes
Scirpus maritimus	Helophytes
Scirpus sect. Pterolepis-type	Helophytes
Scleranthus	Herbs
Scorzonera-type	Herbs
Scrophularia-type	Herbs
Scrophulariaceae	Herbs
Secale	Herbs
Secale cereale	Herbs
Sedum	Herbs
Sedum cf. S. villosum/S. anglicum	Herbs
Sedum/Rhodiola cf. R. rosea	Herbs
Sempervivum	Herbs
Senecio-type	Herbs
Serratula-type	Herbs
Sibbaldia procumbens	Herbs
Silene cf. S. acaulis	Herbs
Silene dioica-type	Herbs
Silene vulgaris-type	Herbs
Silene-type	Herbs
Sinapis-type	Herbs
Sisyrinchium	Herbs
Sisyrinchium-type	Herbs
Sium-type	Herbs
Smilacina stellata	Herbs
Solanaceae	Herbs
Solanum cf. S. nigrum	Herbs
Solanum dulcamara	Herbs
Solanum dulcamara-type	Herbs
Solanum nigrum	Herbs
Solidago-type	Herbs
Sorbus	Trees and shrubs
Sorbus aucuparia	Trees and shrubs
Sorbus-type	Trees and shrubs
Sparganium	Helophytes
Sparganium erectum-type	Helophytes
Sparganium-type	Helophytes
Spergula	Herbs
Spergula arvensis	Herbs
Spergula-type	Herbs
Spergularia-type	Herbs
Stachys-type	Herbs
Stellaria	Herbs
Stellaria holostea	Herbs
Stellaria undiff.	Herbs
Stratiotes	Aquatics
Succisa	Herbs
Succisa pratensis	Herbs
Symphytum	Herbs
Symphytum-type	Herbs
Tamarix	Trees and shrubs
Tamus communis	Herbs
Taraxacum-type	Herbs
Taxodiaceae	Trees and shrubs
Taxus	Trees and shrubs
Taxus baccata	Trees and shrubs
Teucrium	Herbs
Teucrium scordonia	Herbs
Teucrium-type	Herbs
Thalictrum	Herbs
Thalictrum-type	Herbs
Thesium	Herbs
Thymelaeaceae	Trees and shrubs
Thymus-type	Herbs
Tilia	Trees and shrubs
Tilia cordata	Trees and shrubs
Tofieldia	Herbs
Torilis	Herbs
Trapa	Aquatics
Trientalis	Herbs
Trifolium	Herbs
Trifolium medium-type	Herbs
Trifolium montanum	Herbs
Olea europaea	Trees and shrubs
Trifolium montanum-type	Herbs
Trifolium spadiceum	Herbs
Trifolium undiff.	Herbs
Trifolium-type	Herbs
Triglochin	Helophytes
Triticum	Herbs
Triticum undiff.	Herbs
Triticum-type	Herbs
Trollius	Herbs
Trollius europaeus	Herbs
Tsuga	Trees and shrubs
Tsuga mertensiana	Trees and shrubs
Tsuga undiff.	Trees and shrubs
Tulipa sylvestris	Herbs
Typha angustifolia	Helophytes
Typha angustifolia-type	Helophytes
Typha angustifolia/Sparganium	Helophytes
Typha latifolia	Helophytes
Typha latifolia-type	Helophytes
Typha undiff.	Helophytes
Typha undiff. (tetrad)	Helophytes
Typha-type	Helophytes
Ulex-type	Trees and shrubs
Ulmus	Trees and shrubs
Umbelliferae	Herbs
Umbelliferae (type 1)	Herbs
Umbelliferae (type 2)	Herbs
Umbelliferae (type 3)	Herbs
Umbelliferae undiff.	Herbs
Umbilicus	Herbs
Umbilicus-type	Herbs
Urtica	Herbs
Urtica dioica	Herbs
Urtica dioica-type	Herbs
Urtica urens	Herbs
Urtica-type	Herbs
Urticaceae	Herbs
Utricularia	Aquatics
Vaccinium	Dwarf shrubs
Vaccinium myrtillus-type	Dwarf shrubs
Vaccinium-type	Dwarf shrubs
Valeriana	Herbs
Valeriana officinalis	Herbs
Valerianaceae	Herbs
Valerianella	Herbs
Verbascum	Herbs
Verbena	Herbs
Veronica	Herbs
Veronica-type	Herbs
Viburnum	Trees and shrubs
Viburnum opulus	Trees and shrubs
Vicia	Herbs
Vicia cf. V. cracca	Herbs
Vicia cracca-type	Herbs
Vicia faba	Herbs
Vicia sylvatica-type	Herbs
Vicia-type	Herbs
Vicia/Lathyrus	Herbs
Viola	Herbs
Viola arvensis	Herbs
Viola arvensis-type	Herbs
Viola palustris-type	Herbs
Viola riviniana-type	Herbs
Viola tricolor	Herbs
Violaceae	Herbs
Viscum	Trees and shrubs
Vitex agnus-castus	Trees and shrubs
Vitis	Trees and shrubs
Vitis vinifera	Trees and shrubs
Xanthium	Herbs
Zea mays	Herbs
Zelkova	Trees and shrubs
Anogramma leptophylla	Vascular cryptogams (Pteridophytes)
Asplenium-type	Vascular cryptogams (Pteridophytes)
Athyrium filix-femina	Vascular cryptogams (Pteridophytes)
Botrychium	Vascular cryptogams (Pteridophytes)
Botrychium boreale-type	Vascular cryptogams (Pteridophytes)
Botrychium lunaria	Vascular cryptogams (Pteridophytes)
Botrychium lunaria-type	Vascular cryptogams (Pteridophytes)
Botrychium multifidum	Vascular cryptogams (Pteridophytes)
Botrychium virginianum	Vascular cryptogams (Pteridophytes)
Blechnum spicant	Vascular cryptogams (Pteridophytes)
cf. Cystopteris	Vascular cryptogams (Pteridophytes)
Cheilanthes	Vascular cryptogams (Pteridophytes)
Cystopteris fragilis	Vascular cryptogams (Pteridophytes)
Cystopteris fragilis-type	Vascular cryptogams (Pteridophytes)
Cystopteris-type	Vascular cryptogams (Pteridophytes)
Cystopteris undiff.	Vascular cryptogams (Pteridophytes)
Scrophulariaceae (colporate-reticulate)	Herbs
Cryptogramma crispa	Vascular cryptogams (Pteridophytes)
Diphasium alpinum	Vascular cryptogams (Pteridophytes)
Diphasium cf. D. alpinum	Vascular cryptogams (Pteridophytes)
Diphasium complanatum-type	Vascular cryptogams (Pteridophytes)
Dryopteris	Vascular cryptogams (Pteridophytes)
Dryopteris carthusiana-type	Vascular cryptogams (Pteridophytes)
Dryopteris dilatata	Vascular cryptogams (Pteridophytes)
Dryopteris filix-mas	Vascular cryptogams (Pteridophytes)
Dryopteris filix-mas-type	Vascular cryptogams (Pteridophytes)
Dryopteris-type	Vascular cryptogams (Pteridophytes)
Equisetum	Vascular cryptogams (Pteridophytes)
Filicopsida	Vascular cryptogams (Pteridophytes)
Filicopsida trilete undiff.	Vascular cryptogams (Pteridophytes)
Filicopsida monolete undiff.	Vascular cryptogams (Pteridophytes)
Filicopsida undiff.	Vascular cryptogams (Pteridophytes)
Gymnocarpium	Vascular cryptogams (Pteridophytes)
Gymnocarpium dryopteris	Vascular cryptogams (Pteridophytes)
Gymnocarpium dryopteris-type	Vascular cryptogams (Pteridophytes)
Huperzia selago	Vascular cryptogams (Pteridophytes)
Hymenophyllum	Vascular cryptogams (Pteridophytes)
Isoetes	Aquatic Pteridophyta
Isoetes lacustris	Aquatic Pteridophyta
Isoetes setacea	Aquatic Pteridophyta
Lepidotis inundata	Vascular cryptogams (Pteridophytes)
Lycopodiaceae	Vascular cryptogams (Pteridophytes)
Lycopodiaceae undiff.	Vascular cryptogams (Pteridophytes)
Lycopodium	Vascular cryptogams (Pteridophytes)
Lycopodium cf. L. clavatum (tetrad)	Vascular cryptogams (Pteridophytes)
Lycopodium annotinum	Vascular cryptogams (Pteridophytes)
Lycopodium clavatum	Vascular cryptogams (Pteridophytes)
Lycopodium undiff.	Vascular cryptogams (Pteridophytes)
Matteuccia	Vascular cryptogams (Pteridophytes)
Matteuccia-type	Vascular cryptogams (Pteridophytes)
Lamiaceae (hexacolpate)	Herbs
Osmunda regalis	Vascular cryptogams (Pteridophytes)
Ophioglossum	Vascular cryptogams (Pteridophytes)
Pilularia	Aquatic Pteridophyta
Polypodium	Vascular cryptogams (Pteridophytes)
Polypodium vulgare	Vascular cryptogams (Pteridophytes)
Polypodium vulgare-type	Vascular cryptogams (Pteridophytes)
Polystichum-type	Vascular cryptogams (Pteridophytes)
Pteridium	Vascular cryptogams (Pteridophytes)
Pteridium aquilinum	Vascular cryptogams (Pteridophytes)
Pteridium-type	Vascular cryptogams (Pteridophytes)
Pteridophyta monolete undiff.	Vascular cryptogams (Pteridophytes)
Pteridophyta trilete undiff.	Vascular cryptogams (Pteridophytes)
Pteridophyta undiff.	Vascular cryptogams (Pteridophytes)
Salvinia	Aquatic Pteridophyta
Salvinia natans	Aquatic Pteridophyta
Selaginella	Vascular cryptogams (Pteridophytes)
Selaginella helvetica	Vascular cryptogams (Pteridophytes)
Selaginella selaginoides	Vascular cryptogams (Pteridophytes)
Thelypteris palustris	Vascular cryptogams (Pteridophytes)
Thelypteris palustris-type	Vascular cryptogams (Pteridophytes)
cf. Thelypteris palustris	Vascular cryptogams (Pteridophytes)
Thelypteris phegopteris	Vascular cryptogams (Pteridophytes)
Woodsia-type	Vascular cryptogams (Pteridophytes)
Indeterminable: broken	Indeterminables and unknowns
Indeterminable: concealed	Indeterminables and unknowns
Indeterminable: corroded	Indeterminables and unknowns
Indeterminable: degraded	Indeterminables and unknowns
Indeterminable: deteriorated	Indeterminables and unknowns
Indeterminable: undiff.	Indeterminables and unknowns
Indeterminable: unknown	Indeterminables and unknowns
Anthoceros punctatus	Bryophytes
Bryophyte spores	Bryophytes
cf. Moss spore	Indeterminables and unknowns
Unknown	Indeterminables and unknowns
Sphagnum	Bryophytes
Fungal spore undiff.	Fungi
Tilletia sphagni	Fungi
Pre-Quaternary spores	Pre-Quaternary type
Abies: stomata	Vegetative microfossils
Ceratophyllum: hairs	Vegetative microfossils
Lamiaceae (tricolpate)	Herbs
Charcoal	Charcoal
Periporate undiff.	Indeterminables and unknowns
Botryococcus	Algae
Pediastrum	Algae
Pediastrum duplex	Algae
Pediastrum integrum	Algae
Nymphaea alba	Aquatics
Indeterminable: crumpled	Indeterminables and unknowns
Cytisus sect. Sarothamnus	Trees and shrubs
Rubus-type	Trees and shrubs
Centaurea jacea	Herbs
Trifolium pratense	Herbs
Trifolium repens	Herbs
Medicago lupulina	Herbs
Potentilla subg. Comarum	Herbs
Anagallis tenella	Herbs
cf. Hottonia	Indeterminables and unknowns
Drosera rotundifolia	Helophytes
Cyperaceae undiff.	Helophytes
Carex-type	Helophytes
Scirpus-type	Helophytes
Gramineae undiff.	Herbs
Vaccinium myrtillus	Dwarf shrubs
Sisymbrium goesingense	Herbs
Armeria maritima (type B)	Herbs
Geum cf. G. urbanum	Herbs
Erica cinerea	Dwarf shrubs
Hyacinthoides/Scilla	Herbs
Hydrocotyle vulgaris	Herbs
Scrophulariaceae undiff.	Herbs
Ulex	Trees and shrubs
Erica cf. E. tetralix	Dwarf shrubs
Erica tetralix	Dwarf shrubs
Lotus cf. L. corniculatus	Herbs
Ophioglossum vulgatum	Vascular cryptogams (Pteridophytes)
Saxifraga cf. S. cespitosa	Herbs
cf. Trollius europaeus	Indeterminables and unknowns
Rosaceae subg. Amygdalus	Trees and shrubs
Plantago cf. P. media	Herbs
Polytrichum	Bryophytes
Vicia cf. V. sepium	Herbs
Microthyriaceae	Fungi
cf. Cornus suecica	Trees and shrubs
Ranunculus cf. R. bulbosus	Herbs
cf. Myrica	Trees and shrubs
cf. Pilularia	Indeterminables and unknowns
Vicia cf. V. hirsuta	Herbs
Armeria/Limonium	Herbs
Campanula cf. C. rotundifolia	Herbs
cf. Astragalus	Indeterminables and unknowns
cf. Viburnum	Indeterminables and unknowns
Astragalus cf. A. glycyphyllos	Herbs
Arctium cf. A. minus	Herbs
Saussurea	Herbs
Compositae undiff.	Herbs
Chenopodiaceae/Amaranthaceae	Herbs
Saxifraga cf. S. rivularis	Herbs
cf. Campanula	Herbs
Saxifraga cf. S. hypnoides	Herbs
Betula nana-type	Dwarf shrubs
cf. Labiatae	Indeterminables and unknowns
cf. Rubus	Trees and shrubs
Lycopodium cf. L. annotinum	Vascular cryptogams (Pteridophytes)
Valeriana undiff.	Herbs
Pastinaca-type	Herbs
Ambrosia	Herbs
Rhynchospora	Helophytes
Lysimachia cf. L. vulgaris	Herbs
Celtis australis	Trees and shrubs
Sphagnum imbricatum	Macrofossils
Leguminosae cf. Astragalus	Herbs
Cruciferae-type	Herbs
Sagina cf. S. nodosa	Herbs
Anthriscus caucalis	Herbs
Pinus cembra	Trees and shrubs
Compositae	Herbs
Thelypteris-type	Vascular cryptogams (Pteridophytes)
Leptobasis goesingense	Algae
Bryophyte spores undiff.	Bryophytes
Lotus uliginosus-type	Herbs
cf. Rhodiola rosea	Indeterminables and unknowns
Carduus	Herbs
Hypericum pulchrum	Herbs
Betula pubescens	Trees and shrubs
Elymus	Herbs
Diphasium alpinum-type	Vascular cryptogams (Pteridophytes)
Acer pseudoplatanus	Trees and shrubs
Prunus spinosa-type	Trees and shrubs
Prunus avium	Trees and shrubs
Chenopodium	Herbs
Viburnum lantana	Trees and shrubs
Sherardia arvensis	Herbs
Linum perenne	Herbs
Arenaria/Silene	Herbs
Rhizopoda	Rhizopods
Fungal Hyphae	Fungi
Prunus avium/P. spinosa	Trees and shrubs
Varia	Indeterminables and unknowns
Filipendula vulgaris	Herbs
Chrysosplenium oppositifolium	Helophytes
cf. Ophioglossum vulgatum	Vascular cryptogams (Pteridophytes)
Viola palustris	Herbs
Trifolium pratense-type	Herbs
Salix pentandra-type	Trees and shrubs
Hypericum androsaemum	Herbs
Trifolium repens-type	Herbs
cf. Carpinus betulus	Indeterminables and unknowns
Liliaceae undiff.	Herbs
Lobelia/Digitalis	Herbs
cf. Geranium	Indeterminables and unknowns
Clematis	Trees and shrubs
Acer cf. A. negundo	Trees and shrubs
Spergularia	Herbs
Polygonum lapathifolium	Herbs
cf. Chrysosplenium	Indeterminables and unknowns
cf. Geum	Indeterminables and unknowns
cf. Digitalis	Indeterminables and unknowns
Rhamnus-type	Trees and shrubs
Linum cf. L. perenne subsp. anglicum	Herbs
Senecio	Herbs
Lycopodium-type	Vascular cryptogams (Pteridophytes)
Papaver-type	Herbs
Rubiaceae cf. Galium	Herbs
Betula pubescens subsp. tortuosa	Trees and shrubs
Salix reticulata	Trees and shrubs
Centaurea-type	Herbs
Sedum-type	Herbs
Polygonum cf. P. bistorta	Herbs
Scutellaria	Herbs
cf. Rubus idaeus	Trees and shrubs
Cladium-type	Helophytes
Vaccinium oxycoccos	Dwarf shrubs
Orthilia cf. O. secunda	Dwarf shrubs
Sedum anglicum	Herbs
cf. Anagallis	Indeterminables and unknowns
cf. Oxyria	Indeterminables and unknowns
cf. Tussilago	Indeterminables and unknowns
Bartsia-type	Herbs
Scrophularia nodosa-type	Herbs
Mahonia	Trees and shrubs
cf. Callitriche	Indeterminables and unknowns
cf. Isoetes	Indeterminables and unknowns
cf. Tofieldia	Indeterminables and unknowns
cf. Gentianella campestris	Herbs
cf. Calluna	Dwarf shrubs
Astragalus alpinus-type	Herbs
Narthecium-type	Herbs
Dicotyledones	Indeterminables and unknowns
Monocotyledones	Indeterminables and unknowns
Isoetes (type A)	Aquatic Pteridophyta
Encalypta rhabdocarpa	Bryophytes
cf. Quercus	Indeterminables and unknowns
Cornus mas	Trees and shrubs
Plantago alpina-type	Herbs
Quercus coccifera	Trees and shrubs
Aceraceae	Trees and shrubs
Syringa	Trees and shrubs
Rhamnus/Paliurus	Trees and shrubs
Rhodiola rosea	Herbs
Acer campestre	Trees and shrubs
Anemone	Herbs
Antennaria-type	Herbs
Apium nodiflorum	Herbs
Apium-type	Herbs
Arctostaphylos	Dwarf shrubs
Arctostaphylos undiff.	Dwarf shrubs
Armeria maritima (type A)	Herbs
Athyrium distentifolium-type	Vascular cryptogams (Pteridophytes)
Berula-type	Helophytes
Caltha palustris-type	Helophytes
Cannabaceae	Herbs
Cerastium fontanum subsp. triviale	Herbs
Cerastium undiff.	Herbs
cf. Astragalus danicus	Herbs
cf. Cladium mariscus	Helophytes
cf. Frangula	Indeterminables and unknowns
cf. Lotus	Indeterminables and unknowns
Jasminum	Trees and shrubs
cf. Mercurialis	Indeterminables and unknowns
cf. Oxytropis	Indeterminables and unknowns
cf. Taraxacum	Herbs
cf. Populus	Indeterminables and unknowns
cf. Rhodiola	Indeterminables and unknowns
cf. Salix herbacea	Trees and shrubs
cf. Vicia	Indeterminables and unknowns
Circaea lutetiana	Herbs
Convolvulus arvensis	Herbs
Corydalis claviculata	Herbs
Cruciferae undiff.	Herbs
Cystopteris	Vascular cryptogams (Pteridophytes)
Drosera cf. D. intermedia	Helophytes
Exotic grains	Nonpollen
Helleborus	Herbs
Glyceria-type	Herbs
Helianthemum nummularium	Herbs
Heracleum sphondylium	Herbs
Hippophae rhamnoides	Trees and shrubs
Hymenophyllum wilsonii	Vascular cryptogams (Pteridophytes)
Hystrichosphaerids	Dinoflagellates
Solanum-type	Herbs
Jasione montana-type	Herbs
Labiatae undiff.	Herbs
Linum perenne subsp. anglicum	Herbs
Lotus undiff.	Herbs
Lychnis	Herbs
Lycopodium clavatum-type	Vascular cryptogams (Pteridophytes)
Lysimachia vulgaris-type	Herbs
Microthyrium	Fungi
Montia fontana	Herbs
Myrica-type	Trees and shrubs
Oxyria digyna	Herbs
Phragmites-type	Herbs
Polygonum oxyspermum subsp. raii	Herbs
Polygonum undiff.	Herbs
Ranunculus repens-type	Herbs
Rubus fruticosus-type	Trees and shrubs
Rumex crispus	Herbs
Rumex obtusifolius	Herbs
Sagittaria sagitifolia	Helophytes
Scrophularia/Verbascum	Herbs
Salix undiff.	Trees and shrubs
Samolus	Herbs
Samolus valerandi	Herbs
Sanicula europaea	Herbs
Saxifraga cf. S. aizoides	Herbs
Saxifraga granulata	Herbs
Scleranthus-type	Herbs
Sedum acre	Herbs
Silene vulgaris subsp. maritima-type	Herbs
Solanum	Herbs
Sorbus aria	Trees and shrubs
Sorbus cf. S. rupicola	Trees and shrubs
Sparganium cf. S. minimum	Helophytes
Sparganium emersum-type	Helophytes
Sparganium erectum	Helophytes
Spergula/Spergularia	Herbs
Stachys	Herbs
Stellaria-type	Herbs
Tilia platyphyllos	Trees and shrubs
Tofieldia pusilla	Herbs
Trifolium cf. T. repens	Herbs
Vicia cracca	Herbs
Viscum album	Trees and shrubs
Xanthium-type	Herbs
Ranunculus lingua	Herbs
cf. Ligusticum	Herbs
Atriplex	Herbs
cf. Atriplex	Herbs
Silene	Herbs
cf. Silene	Herbs
Cerastium	Herbs
cf. Cerastium	Herbs
cf. Filipendula	Indeterminables and unknowns
Saxifraga rosacea	Herbs
Saxifraga rivularis	Herbs
cf. Epilobium	Herbs
Athyrium	Vascular cryptogams (Pteridophytes)
cf. Athyrium	Vascular cryptogams (Pteridophytes)
cf. Sorbus	Trees and shrubs
cf. Pteridium	Vascular cryptogams (Pteridophytes)
cf. Thymus	Herbs
cf. Odontites	Indeterminables and unknowns
Ephedra strobilaceae-type	Trees and shrubs
Helianthemum oelandicum-type	Herbs
Rhamnus/Frangula	Trees and shrubs
Pimpinella major-type	Herbs
Labiatae cf. Marrubium	Herbs
Radiola linoides	Herbs
Rumex-type	Herbs
Ranunculus subg. Batrachium-type	Aquatics
Derived spores	Indeterminables and unknowns
Secale-type	Herbs
Pinus: stomata	Vegetative microfossils
Hystrix	Dinoflagellates
Ledum palustre	Dwarf shrubs
Gypsophila-type	Herbs
Bryales	Bryophytes
Pediastrum boryanum	Algae
Amphitrema flavum	Rhizopods
Euglypha	Rhizopods
Colchicum-type	Herbs
Mougeotia	Algae
Scheuchzeria palustris	Helophytes
Staurastrum	Algae
Sambucus nigra-type	Trees and shrubs
Botryococcus braunii	Algae
Papaveraceae	Herbs
Pediastrum boryanum subsp. boryanum	Algae
Pediastrum boryanum subsp. cornutum	Algae
Pediastrum boryanum subsp. longicorne	Algae
Pediastrum duplex subsp. rugulosum	Algae
Pediastrum simplex	Algae
Coelastrum reticulatum	Algae
Scenedesmus	Algae
Tetraedron minimum	Algae
cf. Ceratophyllum trichome	Indeterminables and unknowns
Pediastrum undiff.	Algae
Trochiscia undiff.	Algae
cf. Amphitrema flavum	Rhizopods
cf. Euglypha	Indeterminables and unknowns
Adiantum	Vascular cryptogams (Pteridophytes)
Anemone nemorosa	Herbs
Anthericum-type	Herbs
Ephedra fragilis subsp. campylopoda	Trees and shrubs
Ferula-type	Herbs
Jurinea-type	Herbs
Pinus diploxylon	Trees and shrubs
Pinus peuce	Trees and shrubs
Saxifraga hirsuta-type	Herbs
Salix glauca-type	Trees and shrubs
Trifolium alpestre-type	Herbs
Veratrum-type	Herbs
Verbascum-type	Herbs
Adonis-type	Herbs
Aster/Achillea	Herbs
Pinus halepensis	Trees and shrubs
Taraxacum	Herbs
Carduus-type	Herbs
Carpinus orientalis	Trees and shrubs
Centaurea depressa-type	Herbs
Geraniaceae	Herbs
Glaucium-type	Herbs
Aquilegia	Herbs
Trapa natans	Aquatics
Valeriana-type	Herbs
Arbutus unedo	Trees and shrubs
Asphodelus albus	Herbs
Betula alba	Trees and shrubs
Erica australis	Dwarf shrubs
Erica umbellata	Dwarf shrubs
Erica arborea-type	Trees and shrubs
Fritillaria lusitanica	Herbs
Gentiana lutea/G. pneumonanthe	Herbs
Halimium-type	Herbs
Hedwigia	Bryophytes
Helianthemum-type	Herbs
Juglans regia	Trees and shrubs
Liliaceae-type undiff.	Herbs
Narcissus bulbocodium	Herbs
Narcissus pseudonarcissus-type	Herbs
Nigella	Herbs
Olea europaea-type	Trees and shrubs
Pedicularis sylvatica	Herbs
Pinus pinaster	Trees and shrubs
Pinus sylvestris-type	Trees and shrubs
Sanguisorba officinalis-type	Herbs
Cytisus grandiflorus	Trees and shrubs
Veratrum album	Herbs
Epilobium angustifolium	Herbs
Gentiana undiff.	Herbs
cf. Prunus	Trees and shrubs
cf. Huperzia selago	Vascular cryptogams (Pteridophytes)
cf. Cirsium	Herbs
Hedysarum-type	Herbs
Boraginaceae cf. Cynoglossum	Herbs
Diphasium complanatum	Vascular cryptogams (Pteridophytes)
Calla palustris	Helophytes
Scrophularia	Herbs
Genista	Trees and shrubs
Hystrix (type B)	Dinoflagellates
Hystrix (type A)	Dinoflagellates
Rumex cf. R. hydrolapathum	Herbs
Rumex hydrolapathum	Herbs
Valeriana cf. V. officinalis subsp. sambucifolia	Herbs
Trifolium striatum	Herbs
Amphitrema	Rhizopods
Daphne mezereum	Dwarf shrubs
cf. Plantago media	Herbs
cf. Parnassia	Indeterminables and unknowns
cf. Centaurea cyanus	Herbs
Betula-type	Trees and shrubs
Gentianella campestris-type	Herbs
Anthemis	Herbs
Astragalus cf. A. alpinus	Herbs
Gentiana-type	Herbs
Ligustrum vulgare	Trees and shrubs
Pinguicula vulgaris	Herbs
Saxifraga aizoides-type	Herbs
Sorbus cf. S. aucuparia	Trees and shrubs
Prunus spinosa	Trees and shrubs
Thelypteris	Vascular cryptogams (Pteridophytes)
Sorbus undiff.	Trees and shrubs
Dryopteris carthusiana	Vascular cryptogams (Pteridophytes)
Artemisia norvegica-type	Herbs
Oxytropis	Herbs
Caltha palustris	Helophytes
cf. Dryopteris filix-mas	Vascular cryptogams (Pteridophytes)
Hedysarum cf. H. hedysaroides	Herbs
cf. Plantago coronopus	Herbs
cf. Narthecium	Indeterminables and unknowns
Rumex cf. R. acetosa	Herbs
Artemisia campestris-type	Herbs
cf. Menyanthes	Indeterminables and unknowns
cf. Hippophae rhamnoides	Indeterminables and unknowns
cf. Leguminosae	Indeterminables and unknowns
Helianthemum nummularium-type	Herbs
Salix anther	Macrofossils
cf. Saxifraga oppositifolia	Herbs
Valeriana dioica	Herbs
Cerastium/Stellaria	Herbs
Vaccinium subg. Oxycoccus	Dwarf shrubs
Trilete spore(s) undiff.	Vascular cryptogams (Pteridophytes)
Trilete spore(s)	Vascular cryptogams (Pteridophytes)
Scleranthus annuus	Herbs
Rosaceae (type A)	Trees and shrubs
Rosaceae (type B)	Trees and shrubs
Monolete spore(s)	Vascular cryptogams (Pteridophytes)
Botrychium-type	Vascular cryptogams (Pteridophytes)
Gypsophila repens-type	Herbs
Gentianella amarella-type	Herbs
Cistus undiff.	Trees and shrubs
Corema album	Dwarf shrubs
Erica australis-type	Dwarf shrubs
Erica lusitanica	Dwarf shrubs
Erica umbellata-type	Dwarf shrubs
Loeflingia	Herbs
Ononis baetica-type	Herbs
Pimpinella	Herbs
Chenopodiaceae-type	Herbs
Tilia x vulgaris	Trees and shrubs
Sparganium minimum-type	Helophytes
Tilletia	Fungi
Typhaceae	Helophytes
Myricaceae	Trees and shrubs
Equisetaceae	Vascular cryptogams (Pteridophytes)
Sparganiaceae	Helophytes
Drosera anglica	Helophytes
Hyacinthoides	Herbs
cf. Gentiana pneumonanthe	Herbs
Oxyria (type 1)	Herbs
Oxyria (type 2)	Herbs
Ranunculaceae (type 1)	Herbs
Ranunculaceae (type 2)	Herbs
cf. Oxyria/Rumex acetosa	Indeterminables and unknowns
Saxifraga caesia	Herbs
Picea omorika	Trees and shrubs
Riccia-type	Bryophytes
Knautia/Succisa	Herbs
cf. Papilionaceae	Indeterminables and unknowns
Ranunculus repens	Herbs
Anthoceros	Bryophytes
Scleranthus perennis	Herbs
Pinus (type A)	Trees and shrubs
Unknown pollen	Indeterminables and unknowns
Unknown spore(s)	Indeterminables and unknowns
Sagina cf. S. procumbens	Herbs
Monolete spore(s) undiff.	Vascular cryptogams (Pteridophytes)
Paronychia	Herbs
Cichorium-type	Herbs
Crepis	Herbs
Malcolmia	Herbs
Paronychia-type	Herbs
Celastraceae	Trees and shrubs
Nuphar pumila	Aquatics
Pinus (type 2)	Trees and shrubs
Plantago-type	Herbs
Calligonum	Trees and shrubs
Calligonum comosum	Trees and shrubs
Coriaria myrtifolia	Trees and shrubs
Pistacia terebinthus	Trees and shrubs
Juniperus: stomata	Vegetative microfossils
Larix: stomata	Vegetative microfossils
Liliaceae-type	Herbs
Lilium martagon-type	Herbs
Myosotis arvensis-type	Herbs
Picea: stomata	Vegetative microfossils
Plantago montana-type	Herbs
Selaginella helvetica-type	Vascular cryptogams (Pteridophytes)
Veratrum	Herbs
Plantago atrata-type	Herbs
Jasione-type	Herbs
Cornus mas/C. suecica	Trees and shrubs
Athyrium alpestre-type	Vascular cryptogams (Pteridophytes)
Avena/Triticum-type	Herbs
Calystegia-type	Herbs
Cannabis sativa	Herbs
Echium/Onosma	Herbs
Erica arborea	Trees and shrubs
Erica cinerea/E. tetralix	Dwarf shrubs
Glaux maritima	Herbs
Hottonia palustris	Herbs
Hypericum calycinum-type	Herbs
Lycopodium annotinum-type	Vascular cryptogams (Pteridophytes)
Mercurialis perennis-type	Herbs
Plantago coronopus-type	Herbs
Polystichum	Vascular cryptogams (Pteridophytes)
Avena/Triticum	Herbs
Agrimonia/Aremonia	Herbs
Cytisus scoparius-type	Trees and shrubs
Alchemilla/Aphanes	Herbs
Asphodelus/Asphodeline	Herbs
Athyrium/Woodsia	Vascular cryptogams (Pteridophytes)
Primula veris-type	Herbs
Quercus ilex	Trees and shrubs
Quercus suber	Trees and shrubs
Acer campestre-type	Trees and shrubs
Carya-type	Trees and shrubs
Pediastrum araneosum	Algae
Thalictrum alpinum	Herbs
cf. Aesculus	Indeterminables and unknowns
Potamogeton cf. P. pectinatus	Aquatics
cf. Vicia cracca	Indeterminables and unknowns
Triglochin cf. T. palustris	Helophytes
Erica cf. E. cinerea	Dwarf shrubs
Prunus cf. P. avium	Trees and shrubs
Euphorbia-type	Herbs
Primula-type	Herbs
Verbena officinalis	Herbs
cf. Crocus	Indeterminables and unknowns
Stachys/Lamium	Herbs
Helianthemum oelandicum subsp. alpestre	Herbs
Limonium	Herbs
Plantago cf. P. lanceolata	Herbs
Anagallis arvensis	Herbs
Assulina	Rhizopods
Tetraedron cf. T. minimum	Algae
Euastrum cf. E. pectinatum	Algae
cf. Medicago falcata	Indeterminables and unknowns
Saxifraga cernua/S. rivularis	Herbs
Artemisia (Type A)	Herbs
Artemisia (Type B)	Herbs
Artemisia (Type C)	Herbs
Artemisia (Type D)	Herbs
Gentiana cf. G. verna	Herbs
Arenaria-type sensu lato	Herbs
cf. Sagina	Herbs
Gypsophila fastigiata/G. repens	Herbs
Sedum acre-type	Herbs
cf. Frangula alnus	Indeterminables and unknowns
Gentianella cf. G. amarella	Herbs
Scenedesmus undiff.	Algae
Pediastrum angulosum var. asperum	Algae
Sambucus cf. S. nigra	Trees and shrubs
Linum flavum	Herbs
Centaurea undiff.	Herbs
Triglochin-type	Helophytes
Spirogyra	Algae
Amphitrema wrightiana	Rhizopods
Amphitrema undiff.	Rhizopods
Polypodium-type	Vascular cryptogams (Pteridophytes)
Oenanthe-type	Herbs
Ceratophyllum	Vegetative microfossils
Pediastrum angulosum	Algae
Centropyxis aculeata	Algae
Centaurea rhenana-type	Herbs
Scabiosa-type	Herbs
Knautia arvensis	Herbs
Iris-type	Herbs
Casuarina	Trees and shrubs
Elaeagnus	Trees and shrubs
Morus	Trees and shrubs
Punica granatum	Trees and shrubs
Thymelaea	Trees and shrubs
Leontice leontopetalum	Herbs
Anchusa/Pulmonaria	Herbs
Arnebia-type	Herbs
Moltkia	Herbs
Onosma-type	Herbs
Atriplex-type	Herbs
Spinacia-type	Herbs
Artemisia herba-alba-type	Herbs
Carthamus	Herbs
Cousinia	Herbs
Frankenia hirsuta-type	Herbs
Gladiolus	Herbs
Lupinus	Herbs
Phaseolus	Herbs
Plantago ovata-type	Herbs
Plantago tenuiflora-type	Herbs
Psylliostachys	Herbs
Atraphaxis	Trees and shrubs
Anemone nemorosa-type	Herbs
Aquilegia-type	Herbs
Clematis-type	Trees and shrubs
Ranunculus asiaticus-type	Herbs
Ranunculus sceleratus-type	Herbs
Asperula-type	Herbs
Haplophyllum	Herbs
Ruta	Trees and shrubs
Rhynchocorys	Herbs
Bunium-type	Herbs
Turgenia-type	Herbs
Tribulus terrestris	Herbs
Zygophyllum	Trees and shrubs
Typha undiff. (monad)	Helophytes
Plantago alpina	Herbs
Artemisia rupestris	Herbs
Chenopodium-type	Herbs
Salicornia-type	Herbs
Muscari-type	Herbs
Silene vulgaris subsp. maritima	Herbs
Syringa-type	Trees and shrubs
Ligustrum-type	Trees and shrubs
Salsola	Herbs
Jurinea	Herbs
Tanacetum-type	Herbs
Suaeda-type	Herbs
Centaurea/Serratula	Herbs
Eupatorium-type	Herbs
Succisa-type	Herbs
Quercus robur	Trees and shrubs
Quercus cerris	Trees and shrubs
Carex	Helophytes
Arceuthobium oxycedri	Trees and shrubs
Hypericum perforatum	Herbs
Sinapis	Herbs
Iridaceae	Herbs
Polemoniaceae	Herbs
Impatiens noli-tangere	Herbs
Rumex subg. Rumex-type	Herbs
Riccia	Bryophytes
Alismataceae	Helophytes
Amaryllidaceae	Herbs
Anacardiaceae	Indeterminables and unknowns
Haloragaceae	Aquatics
Nyssaceae	Pre-Quaternary type
Ligusticum	Herbs
Ranunculus flammula	Helophytes
Diphasium alpinum/D. complanatum	Vascular cryptogams (Pteridophytes)
Diphasium	Vascular cryptogams (Pteridophytes)
Orthilia	Dwarf shrubs
Ephedra fragilis subsp. campylopoda-type	Trees and shrubs
Aconitum-type	Herbs
Pedicularis-type	Herbs
Convolvulus-type	Herbs
Chelidonium-type	Herbs
Typha cf. T. angustifolia	Helophytes
Cerealia undiff.	Herbs
Diphasium-type	Vascular cryptogams (Pteridophytes)
Polygonatum	Herbs
Alkanna	Herbs
Ostrya/Carpinus orientalis	Trees and shrubs
Viburnum-type	Trees and shrubs
Phillyrea media	Trees and shrubs
Paliurus	Trees and shrubs
Cirsium/Gundelia	Herbs
Brassica-type	Herbs
Capsella-type	Herbs
Theligonum	Herbs
Scabiosa rotata	Herbs
Thymus/Mentha	Herbs
Urticales	Herbs
Assulina muscorum	Rhizopods
Lycopus europaeus	Herbs
Lythraceae	Herbs
Quercus suber-type	Trees and shrubs
Asphodelus-type	Herbs
Polypodiaceae undiff.	Vascular cryptogams (Pteridophytes)
Melilotus-type	Herbs
Peucedanum palustre-type	Herbs
Ligusticum scoticum	Herbs
Smilax	Herbs
Achillea/Aster	Herbs
Pulsatilla	Herbs
Suaeda	Herbs
Quercus frainetto	Trees and shrubs
Salsola-type	Herbs
Spathiflorae	Herbs
Nigella-type	Herbs
Polygonum-type	Herbs
Lactuca	Herbs
Xeranthemum	Herbs
Asplenium	Vascular cryptogams (Pteridophytes)
Calluna-type	Dwarf shrubs
Periploca	Trees and shrubs
Centaurea depressa	Herbs
Polypodiaceae	Vascular cryptogams (Pteridophytes)
Cannabaceae-type	Herbs
Betula exilis	Dwarf shrubs
Betula platyphylla	Trees and shrubs
Chrozophora tinctoria	Herbs
Artemisia (Type F)	Herbs
Astragalus danicus-type	Herbs
Chlorophyta undiff.	Algae
cf. Arctostaphylos	Dwarf shrubs
Gnaphalium-type	Herbs
Peucedanum-type	Herbs
Acritarchs	Acritarchs
Ephedra strobilacea	Trees and shrubs
cf. Gentiana	Herbs
Campanula/Jasione	Herbs
Eurumex	Herbs
cf. Utricularia	Indeterminables and unknowns
Calystegia sepium	Herbs
Carpinus-type	Trees and shrubs
Gelasinospora	Fungi
Helotium	Fungi
Polygonum lapathifolium-type	Herbs
Rumex hydrolapathum-type	Herbs
Polygonum amphibium-type	Aquatics
Potentilla recta	Herbs
Lychnis viscaria-type	Herbs
Helianthemum cf. H. nummularium	Herbs
Helianthemum cf. H. oelandicum	Herbs
Scirpus lacustris-type	Helophytes
Stachys sylvatica-type	Herbs
Myrica gale	Trees and shrubs
Nymphaea candida	Aquatics
Picea abies	Trees and shrubs
Anemone/Hepatica	Herbs
cf. Scleranthus	Herbs
Lythrum portula	Herbs
Potentilla comarum	Herbs
Tilia platyphyllos-type	Trees and shrubs
Anthriscus sylvestris-type	Herbs
Daucus carota	Herbs
Valeriana officinalis-type	Herbs
Pilularia globulifera	Vascular cryptogams (Pteridophytes)
Dryopteris cristata-type	Vascular cryptogams (Pteridophytes)
Polypodium undiff.	Vascular cryptogams (Pteridophytes)
Schoenus	Helophytes
Spicula	Invertebrates
Pre-Quaternary pollen	Pre-Quaternary type
Alnus viridis subsp. fruticosa	Trees and shrubs
Typha	Helophytes
Lonicera-type	Trees and shrubs
Oxalis-type	Herbs
Portulaca	Herbs
Larix dahurica	Trees and shrubs
Ribes rubrum-type	Trees and shrubs
cf. Valeriana	Indeterminables and unknowns
Arctostaphylos uva-ursi-type	Dwarf shrubs
Eu-Rumex-type	Herbs
Dipsacaceae undiff.	Herbs
Campanulaceae undiff.	Herbs
cf. Calystegia	Indeterminables and unknowns
Scirpus lacustris subsp. lacustris-type	Helophytes
Crataegus/Sorbus	Trees and shrubs
Angelica archangelica-type	Herbs
Cotoneaster-type	Trees and shrubs
Fallopia convolvulus	Herbs
Polypodiaceae-type	Vascular cryptogams (Pteridophytes)
Pinus (half)	Trees and shrubs
Pinus (whole)	Trees and shrubs
Picea (half)	Trees and shrubs
Picea (whole)	Trees and shrubs
Viburnum opulus-type	Trees and shrubs
Rhynchospora alba-type	Helophytes
Polygonaceae undiff.	Herbs
Epilobium angustifolium-type	Herbs
Nymphaea alba-type	Aquatics
Potamogeton sect. Eupotamogeton	Aquatics
Polypodiaceae/Aspidiaceae undiff.	Vascular cryptogams (Pteridophytes)
Astragalus oxytropis-type	Herbs
Scorzonera humilis-type	Herbs
Hordeum/Secale	Herbs
Assulina seminulum	Rhizopods
Habrotrocha	Rotifera (Rotifers)
Helotium schimperi	Fungi
Ranunculus arvensis	Herbs
cf. Marrubium	Indeterminables and unknowns
Arctium/Jurinea	Herbs
Onopordum-type	Herbs
Scabiosa olivieri	Herbs
Hypericum assyrianum-type	Herbs
Pteris	Vascular cryptogams (Pteridophytes)
Ranunculus arvensis-type	Herbs
Ranunculus peltatus-type	Aquatics
Ulex/Sarothamnus	Trees and shrubs
Hammada-type	Trees and shrubs
Evax	Herbs
Portulaca/Montia	Herbs
Anisosciadium-type	Herbs
Nitraria	Trees and shrubs
Lycium-type	Trees and shrubs
Linum mucronatum-type	Herbs
Polygonum cognatum-type	Herbs
Nerium	Trees and shrubs
Styrax	Trees and shrubs
Acanthus	Herbs
Chardinia/Onopordon	Herbs
Bryonia	Herbs
Phlomis	Herbs
Malabaila	Herbs
Urtica pilulifera-type	Herbs
Cotinus coggygria	Trees and shrubs
Mesembryanthemum	Herbs
Centaurea solstitialis	Herbs
Crocus	Herbs
Sideritis	Herbs
Colchicum/Merendera	Herbs
Gossypium	Herbs
Cyclamen	Herbs
Hyoscyamus	Herbs
Liliaceae cf. Narthecium-type	Herbs
Salix herbacea-type	Trees and shrubs
Resedaceae	Herbs
Juncus	Herbs
cf. Juncus	Indeterminables and unknowns
Sanguisorba-type	Herbs
Juglandaceae	Trees and shrubs
cf. Convolvulus	Indeterminables and unknowns
Centaurea rhenana	Herbs
Pediastrum kawraiskyi	Algae
Juglans-type	Trees and shrubs
Hyalosphenia	Rhizopods
Anagallis-type	Herbs
Pinus-type	Trees and shrubs
Polygonum cf. P. lapathifolium	Herbs
cf. Stellaria	Herbs
Polygonum cf. P. persicaria	Herbs
Asphodeline	Herbs
Antirrhinum/Linaria	Herbs
Rubus idaeus-type	Trees and shrubs
Fagopyrum esculentum	Herbs
Trientalis europaea	Herbs
Lobelia dortmanna	Helophytes
Drosera rotundifolia/D. anglica	Helophytes
Stellaria palustris	Herbs
Limnophora	Invertebrates
Betula obscura	Trees and shrubs
Cirsium helenioides	Herbs
Sagina nodosa	Herbs
Araceae	Herbs
Quercus sempervirens-type	Trees and shrubs
cf. Prosopis	Indeterminables and unknowns
Asphodelus albus-type	Herbs
Orobanche	Herbs
Roemeria	Herbs
Hydrocotyle-type	Herbs
Cheilanthes-type	Vascular cryptogams (Pteridophytes)
cf. Equisetum	Indeterminables and unknowns
cf. Lycopodium clavatum	Vascular cryptogams (Pteridophytes)
Anthoceros laevis-type	Bryophytes
Pterocephalus-type	Herbs
Maianthemum	Herbs
Emex	Herbs
Polygonum hydrolapathum	Herbs
Spores	Indeterminables and unknowns
Centaurea nemecii-type	Herbs
Roemeria dodecandra-type	Herbs
Plantago cylindrica-type	Herbs
Pedicularis palustris-type	Herbs
Reseda lutea-type	Herbs
Pteropyrum	Herbs
Viburnum/Sambucus	Trees and shrubs
Valeriana officinalis subsp. sambucifolia	Herbs
Pediastrum clathratum	Algae
Quercus robur/Q. cerris	Trees and shrubs
cf. Prunus-type	Trees and shrubs
cf. Cerastium glomeratum	Herbs
cf. Silene albescens	Herbs
cf. Silene ampullata	Herbs
Vaccaria/Petrorhagia	Herbs
Centaurea cf. Xeranthemum	Herbs
Inula-type	Herbs
Serratula	Herbs
Cephalaria	Herbs
cf. Euphorbiaceae	Indeterminables and unknowns
Mercurialis-type	Herbs
cf. Gentianaceae	Indeterminables and unknowns
Medicago-type	Herbs
cf. Medicago minima	Indeterminables and unknowns
Psoralea	Herbs
cf. Chionodoxa	Indeterminables and unknowns
Eremurus	Herbs
Gagea-type	Herbs
Calligonum aphyllum	Trees and shrubs
Acantholimon	Herbs
Delphinium	Herbs
Callipeltis microstegia-type	Trees and shrubs
Scrophularia/Verbascum/Digitalis	Herbs
cf. Veronica	Indeterminables and unknowns
cf. Bunium rectangulum	Herbs
Echinophora-type	Herbs
cf. Falcaria	Herbs
Lecokia	Herbs
cf. Levisticum	Herbs
Psammogeton-type	Herbs
cf. Smyrniopsis	Herbs
Trachyspermum-type	Herbs
Azolla/Salvinia	Aquatic Pteridophyta
Vaccaria	Herbs
Juniperus sabina	Trees and shrubs
Phillyrea angustifolia	Trees and shrubs
Abutilon	Herbs
Rumex kurdicus	Herbs
Ranunculus circiniatus	Aquatics
Saxifraga rotundifolia	Herbs
Azolla	Aquatic Pteridophyta
cf. Lycopodium	Vascular cryptogams (Pteridophytes)
Pediastrum brevicorne	Algae
Pediastrum divergens	Algae
Pediastrum longicorne	Algae
Pediastrum muticum	Algae
Spiraea	Trees and shrubs
Osmanthus	Trees and shrubs
Cnicus	Herbs
Inula	Herbs
Hedysarum/Ebenus	Herbs
Anthriscus-type	Herbs
Hydrocharis	Aquatics
Marsilea	Vascular cryptogams (Pteridophytes)
Cytisus	Trees and shrubs
Aristolochia	Herbs
Cerinthe-type	Herbs
Calendula	Herbs
Ricinus	Trees and shrubs
Gentiana vernalis-type	Herbs
Nepeta	Herbs
Laurus	Trees and shrubs
Alhagi	Trees and shrubs
Colutea	Trees and shrubs
Hippocrepis	Herbs
Rheum	Herbs
Androsace	Herbs
Actaea	Herbs
Adonis aestivalis	Herbs
Anemone coronaria	Herbs
Consolida	Herbs
Rhynchospora-type	Helophytes
Phyllitis	Vascular cryptogams (Pteridophytes)
Crupina	Herbs
Anthyllis-type	Herbs
Hibiscus	Trees and shrubs
cf. Berberis	Indeterminables and unknowns
Phyteuma-type	Herbs
Anemone undiff.	Herbs
cf. Bongardia	Indeterminables and unknowns
Beta	Herbs
Roemeria-type	Herbs
Rumex cyprius-type	Herbs
Rumex patientia-type	Herbs
Zygophyllaceae	Trees and shrubs
Sanicula	Herbs
Cuscuta europaea-type	Herbs
cf. Sambucus	Indeterminables and unknowns
cf. Ceratonia	Indeterminables and unknowns
cf. Campanulaceae	Indeterminables and unknowns
Artemisia herba-alba	Herbs
cf. Hypericum	Indeterminables and unknowns
Iris pseudacorus	Herbs
Spartium	Trees and shrubs
Fagopyrum tataricum	Herbs
Hydrocharitaceae	Aquatics
Pediastrum undulatum	Algae
cf. Rhus	Indeterminables and unknowns
cf. Loranthaceae	Indeterminables and unknowns
cf. Abies	Trees and shrubs
Bongardia	Herbs
Legousia-type	Herbs
Beta-type	Herbs
Atractylis-type	Herbs
cf. Cruciferae	Indeterminables and unknowns
Gentiana olivieri-type	Herbs
cf. Astragalus-type	Indeterminables and unknowns
cf. Papaveraceae	Indeterminables and unknowns
cf. Acantholimon	Herbs
Statice spicata-type	Herbs
cf. Aconitum	Indeterminables and unknowns
cf. Adonis	Indeterminables and unknowns
Ceratocephalus-type	Herbs
cf. Solanaceae	Indeterminables and unknowns
cf. Thymelaeaceae	Indeterminables and unknowns
cf. Caucalis	Herbs
Picea abies subsp. obovata	Trees and shrubs
Caprifoliaceae	Trees and shrubs
Encalypta	Bryophytes
Selaginella sibirica	Vascular cryptogams (Pteridophytes)
Pinus haploxylon	Trees and shrubs
Alnus hirsuta	Trees and shrubs
Phlox sibirica	Herbs
Botrychium boreale	Vascular cryptogams (Pteridophytes)
Ephedra monosperma	Trees and shrubs
Lonicera periclymenum-type	Trees and shrubs
Lythrum hyssopifolia	Herbs
Philonotis	Bryophytes
Lappula	Herbs
Gentianella tenella	Herbs
Centranthus	Herbs
Scutellaria-type	Herbs
Pulmonaria obscura-type	Herbs
Atropa bella-donna	Herbs
Buglossoides arvensis-type	Herbs
Erica ciliaris-type	Dwarf shrubs
Digitalis purpurea-type	Herbs
Cornus mas-type	Trees and shrubs
Crassula	Herbs
Daphne/Thymeleaea	Trees and shrubs
Consolida ambigua-type	Herbs
Ficus carica	Trees and shrubs
Fritillaria-type	Herbs
Mahonia aquilifolium-type	Trees and shrubs
Pyrola-type	Dwarf shrubs
Monotropa hypopitys	Dwarf shrubs
Papaver radicatum	Herbs
Pleurospermum austriacum-type	Herbs
Larix-type	Trees and shrubs
Solanum nigrum-type	Herbs
Spergula arvensis-type	Herbs
Umbilicus rupestris-type	Herbs
Gentianella tenella-type	Herbs
Potamogeton subg. Potamogeton-type	Aquatics
Abies alba	Trees and shrubs
Polemonium boreale	Herbs
Silene acaulis	Herbs
Trifolium striatum-type	Herbs
cf. Xanthium	Indeterminables and unknowns
Ranunculus trichophyllus	Aquatics
Tilia cordata-type	Trees and shrubs
Lonicera nigra-type	Trees and shrubs
Loranthus	Trees and shrubs
Viburnum cf. V. opulus	Trees and shrubs
Allium vineale-type	Herbs
Astrantia-type	Herbs
Centaurea cf. C. kotschyana	Herbs
Centaurea mollis-type	Herbs
Cerinthe	Herbs
Gentiana asclepiadea-type	Herbs
Gypsophila fastigiata	Herbs
Tussilago-type	Herbs
cf. Myosoton aquaticum	Herbs
Asarum europaeum	Herbs
Leucojum/Galanthus	Herbs
Stellaria cf. S. nemorum	Herbs
Urtica cf. U. dioica	Herbs
Saxifraga cf. S. hirculus	Herbs
Stellaria cf. S. graminea	Herbs
cf. Andromeda polifolia	Dwarf shrubs
cf. Potentilla palustris	Herbs
cf. Swertia	Herbs
cf. Veratrum	Indeterminables and unknowns
Lamiastrum-type	Herbs
Alnus cf. A. viridis	Trees and shrubs
Carex hirta-type	Helophytes
Gypsophila fastigiata-type	Herbs
Lysimachia nummularia	Herbs
Plantago maritima sensu lato	Herbs
Staphylea	Trees and shrubs
Agrostemma githago	Herbs
Arum/Acorus	Indeterminables and unknowns
Epipactis palustris	Herbs
Glechoma-type	Herbs
Petasites-type	Herbs
Phleum-type	Herbs
Polygonatum verticillatum	Herbs
Bilderdykia convolvulus/B. dumetorum	Herbs
Rumex cf. R. obtusifolius	Herbs
Silene undiff.	Herbs
cf. Cannabis	Herbs
cf. Chrysanthemum	Indeterminables and unknowns
cf. Triticum diccocon	Herbs
Potamogeton sect. Coleogeton	Aquatics
Berberis vulgaris	Trees and shrubs
Salix polaris-type	Trees and shrubs
cf. Cannabis sativa	Herbs
Echium vulgare	Herbs
Lithospermum-type	Herbs
Linaria-type	Herbs
Sequoia	Trees and shrubs
Ribes cf. R. rubrum	Trees and shrubs
Fallopia convolvulus-type	Herbs
cf. Bartsia	Indeterminables and unknowns
cf. Viola	Indeterminables and unknowns
Andromeda	Dwarf shrubs
Fontanesia philliraeoides	Trees and shrubs
Punica	Trees and shrubs
Pyrus	Trees and shrubs
Rindera-type	Herbs
Lepidium	Herbs
Datisca	Herbs
Corydalis solida-type	Herbs
Hypecoum	Herbs
Kickxia	Herbs
Juncus/Luzula	Herbs
Nymphoides	Aquatics
Capparis	Trees and shrubs
Descurainia	Herbs
Gentiana purpurea	Herbs
Hordeum/Triticum	Herbs
Chelidonium	Herbs
Rumex cyprius	Herbs
Datura	Herbs
Epipactis	Herbs
Sambucus racemosa-type	Trees and shrubs
Medicago	Herbs
Melilotus	Herbs
Tulipa-type	Herbs
Ceratocephalus	Herbs
Paracaryum-type	Herbs
Littorella-type	Aquatics
Chardinia	Herbs
Centaurium-type	Herbs
Plantaginaceae undiff.	Herbs
Aruncus	Herbs
Reaumuria	Trees and shrubs
Tribulus	Herbs
Plantago arenaria	Herbs
Betulaceae	Trees and shrubs
Pleurospermum-type	Herbs
Pimpinella saxifraga-type	Herbs
Potamogetonaceae	Aquatics
Solidago	Herbs
Chaerophyllum	Herbs
Peucedanum	Herbs
Potentilla subg. Comarum-type	Herbs
Plantago major/P. maritima	Herbs
Anthocerothales	Bryophytes
Bupleurum falcatum-type	Herbs
Convallaria-type	Herbs
Dianthus superbus-type	Herbs
Heracleum sphondylium-type	Herbs
Cerastium fontanum-type	Herbs
cf. Triticum	Herbs
Erica undiff.	Dwarf shrubs
Artemisia sensu stricto	Herbs
Artemisia sensu lato	Herbs
cf. Centaurea	Indeterminables and unknowns
Silybum-type	Herbs
Quercus infectoria-type	Trees and shrubs
Asphodelus fistulosus-type	Herbs
Cichorium	Herbs
Calligonum/Pteropyrum	Trees and shrubs
Linaceae	Herbs
Pediastrum boryanum subsp. brevicorne	Algae
Phillyrea-type	Trees and shrubs
Melandrium rubrum	Herbs
Cistus villosus-type	Trees and shrubs
Arabidopsis-type	Herbs
Cyperus longus-type	Helophytes
Urtica undiff.	Herbs
Corydalis lutea-type	Herbs
Cistus/Helianthemum	Trees and shrubs
Andrachne	Trees and shrubs
Roemeria hybrida-type	Herbs
Doronicum-type	Herbs
Artemisia vulgaris	Herbs
Crepis-type	Herbs
Sanicula-type	Herbs
Peganum	Herbs
Oleaceae/Cruciferae	Indeterminables and unknowns
Trachomitum	Herbs
Nepeta-type	Herbs
Ornithogalum	Herbs
cf. Heracleum sphondylium	Herbs
Ranunculus batrachioides	Aquatics
Erigeron	Herbs
Geranium sylvaticum	Herbs
Saxifraga-type	Herbs
Hippuris vulgaris	Aquatics
Pediastrum boryanum I	Algae
Pediastrum boryanum II	Algae
Pediastrum boryanum III	Algae
Pediastrum boryanum var. rugulatum	Algae
Potamogeton sect. Coleogeton-type	Aquatics
Zygnemataceae	Algae
Monolete psilate	Vascular cryptogams (Pteridophytes)
Pteridophyta (monolete, verrucate)	Vascular cryptogams (Pteridophytes)
Debarya	Fungi
Liriodendron	Pre-Quaternary type
Helianthemum oelandicum subsp. alpestre-type	Herbs
Sparganium emersum	Helophytes
Trollius-type	Herbs
Astrantia	Herbs
Rumex aquaticus	Herbs
Helianthemum canum-type	Herbs
Potamogeton filiformis-type	Aquatics
Chrysanthemum-type	Herbs
Polygonatum verticillatum-type	Herbs
Rumex maritimus-type	Herbs
Phragmites australis-type	Herbs
Potamogeton subg. Eupotamogeton	Aquatics
cf. Typha angustifolia	Indeterminables and unknowns
Montia fontana-type	Herbs
Chrysanthemum	Herbs
Barbarea-type	Herbs
Cardamine pratensis-type	Herbs
Valeriana dioica subsp. simplicifolia	Herbs
Desmidiaceae	Algae
Gentiana verna-type	Herbs
Arcella discoides	Rhizopods
Rhizopoda sp.	Rhizopods
Callidina angusticollis	Rotifera (Rotifers)
Cerinthe minor	Herbs
Anthoceros laevis	Bryophytes
Debarya sp.	Fungi
Spirogyra-type	Algae
Zygnema-type	Algae
Arcella undiff.	Rhizopods
Entophlyctis lobata	Fungi
Ribes cf. R. alpinum	Trees and shrubs
Galeopsis	Herbs
Sambucus cf. S. ebulus	Trees and shrubs
Scheuchzeria-type	Helophytes
Apium inundatum-type	Herbs
Helicoma curtisii	Fungi
cf. Lepidotis inundata	Vascular cryptogams (Pteridophytes)
Betula pubescens sensu lato	Trees and shrubs
Pinus cembra-type	Trees and shrubs
Sambucus cf. S. racemosa	Trees and shrubs
Larix decidua	Trees and shrubs
Viburnum undiff.	Trees and shrubs
Lycopodiella inundata	Vascular cryptogams (Pteridophytes)
Picea abies subsp. abies	Trees and shrubs
Melampyrum-type	Herbs
Eunotia	Algae
Pediastrum biradiatum	Algae
Pediastrum muticum subsp. scutum	Algae
Pinnularia	Algae
Arcella	Rhizopods
Rhizopoda undiff.	Rhizopods
Filipendula-type	Herbs
Lemna minor	Aquatics
Centaurea debeauxii subsp. thuillieri	Herbs
Cicuta virosa	Herbs
Chrysosplenium alternifolium	Helophytes
Lonicera nigra	Trees and shrubs
Lonicera xylosteum	Trees and shrubs
Arnica montana	Herbs
Campanula rotundifolia	Herbs
Gentiana lutea	Herbs
Chrysosplenium undiff.	Helophytes
Pulsatilla alpina	Herbs
Arnica	Herbs
Carum-type	Herbs
Cerastium arvense	Herbs
Daucus	Herbs
Hypericum tetrapterum	Herbs
Polygonum aviculare/P. bistorta	Herbs
Berberidaceae	Trees and shrubs
Chenopodium/Thalictrum	Herbs
Halogeton	Trees and shrubs
Plantago cf. P. crassifolia	Herbs
Statice spicata	Herbs
Androsace-type	Herbs
Anthericum ramosum	Herbs
Chenopodium album	Herbs
Gypsophila muralis	Herbs
Lapsana-type	Herbs
Lotus cf. L. uliginosus	Herbs
cf. Silene alba	Herbs
Sedum/Sempervivum	Herbs
Senecio cf. S. congestus	Herbs
Silene cf. S. nutans	Herbs
Stellaria cf. S. palustris	Herbs
Alyssoides-type	Herbs
Nymphaeaceae: hairs	Vegetative microfossils
Elatine-type	Aquatics
Swertia perennis	Herbs
Cornus cf. C. suecica	Trees and shrubs
Stellaria cf. S. media	Herbs
cf. Herniaria	Indeterminables and unknowns
cf. Montia	Indeterminables and unknowns
Polygala vulgaris	Herbs
Armeria maritima subsp. elongata	Herbs
Diphasium tristachyum	Vascular cryptogams (Pteridophytes)
Rumex conglomeratus-type	Herbs
cf. Lobelia	Indeterminables and unknowns
cf. Littorella	Indeterminables and unknowns
Melilotus officinalis	Herbs
Saxifraga cf. S. nivalis	Herbs
Stratiotes aloides	Aquatics
cf. Humulus	Herbs
Valerianella dentata	Herbs
cf. Cytisus	Indeterminables and unknowns
Heleopera	Rhizopods
Nebela	Rhizopods
Plantago cf. P. alpina	Herbs
Plantago cf. P. coronopus	Herbs
Plantago cf. P. tenuiflora	Herbs
Pyrola	Dwarf shrubs
Amaranthaceae	Herbs
Odontites-type	Herbs
Polygonatum-type	Herbs
Stellaria graminea	Herbs
Hottonia-type	Aquatics
Alisma gramineum-type	Helophytes
Umbelliferae 3	Herbs
Menyanthes trifoliata-type	Helophytes
Chrysosplenium-type	Helophytes
Lysimachia nemorum-type	Herbs
Lythrum salicaria-type	Herbs
Veronica beccabunga-type	Herbs
Ephedra cf. E. fragilis subsp. campylopoda	Trees and shrubs
Cardamine	Herbs
Myriophyllum cf. M. spicatum	Aquatics
Myriophyllum cf. M. verticillatum	Aquatics
Helicoma	Fungi
Nebela undiff.	Rhizopods
Bruckenthalia	Dwarf shrubs
Hymenophyllum tunbrigense	Vascular cryptogams (Pteridophytes)
Hepatica-type	Herbs
Arthrodesmus	Algae
Succisella-type	Trees and shrubs
Botryococcus pila	Algae
cf. Penium	Indeterminables and unknowns
Zygnema	Algae
Zygnemataceae undiff.	Algae
Anthostomella fuegiana	Fungi
Gentiana cruciata-type	Herbs
Fungi undiff.	Fungi
Gaeumannomyces cf. caricis	Fungi
Gelasinospora reticulispora	Fungi
Casuarina/Corylus	Trees and shrubs
cf. Riccia	Indeterminables and unknowns
Pediastrum angulosum subsp. angulosum	Algae
Pediastrum duplex subsp. duplex	Algae
Petasites	Herbs
Diporotheca	Fungi
Butomus-type	Helophytes
Centaurea stoebe	Herbs
Tetraedron	Algae
Tetraploa aristata	Fungi
Succisella	Herbs
Penium	Algae
Cladocera	Microcrustaceans
Rhabdocoela	Platyhelminthes (flatworms)
Dinoflagellates	Dinoflagellates
Butomus	Helophytes
Mougeotia undiff.	Algae
Staurastrum dispar	Algae
Gelasinospora undiff.	Fungi
Euglypha undiff.	Rhizopods
Pteridium aquilinum-type	Vascular cryptogams (Pteridophytes)
Monolete spore sculptured	Vascular cryptogams (Pteridophytes)
Trilete spore sculptured	Vascular cryptogams (Pteridophytes)
Pinus subg. Strobus	Trees and shrubs
Betula sect. Albae	Trees and shrubs
Betula sect. Nanae	Dwarf shrubs
Betula sect. Fruticosae	Dwarf shrubs
Ulmus minor	Trees and shrubs
Rosaceae subf. Maloideae	Trees and shrubs
Larix gmelinii	Trees and shrubs
Ulmus glabra	Trees and shrubs
Tamaricaceae	Trees and shrubs
Quercus boissieri-type	Trees and shrubs
Flamula-type	Indeterminables and unknowns
Lastrea-type	Vascular cryptogams (Pteridophytes)
Rumex acetosa/R. acetosella-type	Herbs
Rumex longifolius	Herbs
cf. Ranunculus	Indeterminables and unknowns
cf. Taxus	Indeterminables and unknowns
Silene/Lychnis	Herbs
cf. Artemisia	Indeterminables and unknowns
cf. Carpinus	Indeterminables and unknowns
Ephedra distachya subsp. helvetica-type	Trees and shrubs
cf. Thalictrum	Indeterminables and unknowns
cf. Ephedra fragilis	Trees and shrubs
cf. Urtica	Indeterminables and unknowns
cf. Ilex	Indeterminables and unknowns
Anthyllis/Lychnis	Indeterminables and unknowns
cf. Acer	Indeterminables and unknowns
cf. Cladium	Helophytes
cf. Cladium-type	Helophytes
Corylond	Trees and shrubs
Fragaria	Herbs
Angelica	Herbs
Galium palustre	Herbs
Typha latifolia/T. angustifolia	Helophytes
Valeriana cf. V. dioica	Herbs
Closterium undiff.	Algae
Pediastrum braunii	Algae
Pediastrum tetras	Algae
Staurastrum undiff.	Algae
Veronica beccabunga	Herbs
Euphrasia-type	Herbs
Gentiana punctata	Herbs
Swertia	Herbs
Triglochin/Potamogeton	Aquatics
Acroptilon	Herbs
cf. Anthericum	Indeterminables and unknowns
Primula elatior-type	Herbs
cf. Gratiola	Indeterminables and unknowns
Cupressus	Trees and shrubs
cf. Casuarina	Indeterminables and unknowns
cf. Cornus	Indeterminables and unknowns
cf. Ligustrum	Indeterminables and unknowns
Arnebia	Herbs
cf. Myosotis-type	Indeterminables and unknowns
Mattiastrum	Herbs
Michauxia	Herbs
cf. Krascheninnikovia	Herbs
cf. Polypodium	Vascular cryptogams (Pteridophytes)
cf. Onobrychis-type	Indeterminables and unknowns
cf. Polygonum bistorta-type	Indeterminables and unknowns
Fraxinus angustifolia subsp. oxycarpa-type	Trees and shrubs
cf. Genista	Indeterminables and unknowns
cf. Myricaria	Indeterminables and unknowns
Amaranthus-type	Herbs
Galanthus	Herbs
Biscutella	Herbs
Dorycnium hirsutum	Herbs
cf. Orobanche	Indeterminables and unknowns
cf. Atraphaxis	Indeterminables and unknowns
Ranunculus parviflorus-type	Herbs
Saxifraga moschata-type	Herbs
Ceratonia	Trees and shrubs
Hymenophyllum flabellatum	Vascular cryptogams (Pteridophytes)
Betula exilis/B. fruticosa	Dwarf shrubs
Polygonum scabrum	Herbs
Anthoceros crispulus	Bryophytes
Osmunda undiff.	Vascular cryptogams (Pteridophytes)
Osmunda cinnamomea	Vascular cryptogams (Pteridophytes)
Pinus sibirica	Trees and shrubs
Ulmus undiff.	Trees and shrubs
Tilia undiff.	Trees and shrubs
Tilia tomentosa	Trees and shrubs
Botrychium undiff.	Vascular cryptogams (Pteridophytes)
Huperzia selago subsp. arctica	Vascular cryptogams (Pteridophytes)
Lycopodium dubium	Vascular cryptogams (Pteridophytes)
Ulmus laevis	Trees and shrubs
Sphagnales	Bryophytes
Alnus incana	Trees and shrubs
Betula cf. B. pendula	Trees and shrubs
Betula cf. B. fruticosa	Trees and shrubs
Steris segetalis	Herbs
Fossombronia	Bryophytes
Avena sativa	Herbs
Rhus/Cotinus	Trees and shrubs
Atractylis cancellata	Herbs
Cornus mas/C. sanguinea	Trees and shrubs
Vitex	Trees and shrubs
Scandix	Herbs
Coronilla	Herbs
Satureja/Ziziphora	Herbs
Hypericum coris-type	Herbs
Cornulaca	Herbs
Parrotia	Trees and shrubs
Pteridium undiff.	Vascular cryptogams (Pteridophytes)
Pediastrum boryanum subsp. divergens	Algae
Pediastrum boryanum subsp. granulosum	Algae
Massulae salvinia	Macrofossils
Scabiosa undiff.	Herbs
Arabidopsis	Herbs
Rebedded	Pre-Quaternary type
Spikes/slide	Nonpollen
Spikes/tablet	Nonpollen
Sample volume (ml)	Nonpollen
Tablets	Nonpollen
Ranunculus sceleratus	Herbs
Lonicera undiff.	Trees and shrubs
Polygonum cf. P. bistorta-type	Herbs
Ephedra cf. E. distachya	Trees and shrubs
Ephedra cf. E. fragilis	Trees and shrubs
Lythrum-type	Herbs
Ophioglossaceae	Vascular cryptogams (Pteridophytes)
Scorzonera	Herbs
Duschekia fruticosa	Trees and shrubs
Hepatica	Herbs
Huperzia serrata	Vascular cryptogams (Pteridophytes)
Butomaceae	Helophytes
Ulmus (type A)	Trees and shrubs
Ulmus (type B)	Trees and shrubs
Andromeda-type	Dwarf shrubs
Helianthus-type	Herbs
Ledum-type	Dwarf shrubs
cf. Dryopteris	Vascular cryptogams (Pteridophytes)
Myriophyllum cf. M. alterniflorum	Aquatics
Ephedra cf. E. strobilacea	Trees and shrubs
Ilex aquifolium-type	Trees and shrubs
cf. Rosa	Trees and shrubs
Rubus undiff.	Trees and shrubs
cf. Chamaenerion	Herbs
cf. Euphorbia	Indeterminables and unknowns
Helianthemum canum/H. alpestre	Herbs
Helianthemum undiff.	Herbs
cf. Koenigia islandica	Indeterminables and unknowns
Linum austriacum-type	Herbs
cf. Lychnis	Herbs
Mercurialis cf. M. perennis	Herbs
cf. Lythrum	Indeterminables and unknowns
cf. Pinguicula	Indeterminables and unknowns
Plantago maritima sensu stricto	Herbs
cf. Saxifraga nivalis	Indeterminables and unknowns
cf. Saxifraga stellaris	Indeterminables and unknowns
Scabiosa canescens-type	Herbs
Dryopteris filix-mas sensu stricto	Vascular cryptogams (Pteridophytes)
Diphasium complanatum/D. tristachyum	Vascular cryptogams (Pteridophytes)
Osmunda regalis/Osmundastrum claytonianum	Vascular cryptogams (Pteridophytes)
Polypodiaceae sensu lato undiff.	Vascular cryptogams (Pteridophytes)
Alisma cf. A. plantago-aquatica	Helophytes
Bolboschoenus maritimus	Helophytes
Nuphar cf. N. lutea	Aquatics
Rumex aquaticus/R. hydrolapathum	Herbs
cf. Viscaria	Herbs
Gentiana/Gentianella	Herbs
Helianthemum oelandicum	Herbs
Delphinium/Aconitum	Herbs
Valeriana/Valerianella	Herbs
Tetraporina	Fungi
Lycopodium annotinum/Diphasium complanatum	Vascular cryptogams (Pteridophytes)
Brasenia	Pre-Quaternary type
Agrimonia cf. A. eupatoria	Herbs
cf. Erica	Dwarf shrubs
Lysimachia nummularia-type	Herbs
cf. Potentilla bifurca subg. Comarum	Herbs
Ranunculus cf. R. sceleratus	Herbs
Rumex sect. Lapathum	Herbs
Plantago cf. P. major	Herbs
Mycota	Fungi
Stellaria nemorum	Herbs
Geum/Potentilla	Herbs
Empetrum nigrum subsp. hermaphroditum	Dwarf shrubs
Bellis	Herbs
Empetraceae	Dwarf shrubs
Ficaria	Herbs
Scorzonera humilis	Herbs
Alnaster	Trees and shrubs
Abies nordmanniana	Trees and shrubs
Picea orientalis	Trees and shrubs
Pterocarya pterocarpa	Trees and shrubs
Fagus orientalis	Trees and shrubs
Pteris cretica	Bryophytes
Athyrium distentifolium	Vascular cryptogams (Pteridophytes)
Santalaceae	Herbs
Aristolochiaceae	Herbs
Oxalidaceae	Herbs
Marsileaceae	Vascular cryptogams (Pteridophytes)
Cornaceae	Trees and shrubs
Balsaminaceae	Herbs
Pyrolaceae	Dwarf shrubs
Sonchus	Herbs
Apocynaceae	Indeterminables and unknowns
Dicranum	Bryophytes
Anthocerotaceae	Bryophytes
Illecebrum	Herbs
Betula pendula	Trees and shrubs
Lychnis/Agrostemma	Herbs
Cedrus libani	Trees and shrubs
Dryopteris oreopteris	Vascular cryptogams (Pteridophytes)
Laurocerasus	Trees and shrubs
Paliurus spina-christi	Trees and shrubs
Polypodium australe	Vascular cryptogams (Pteridophytes)
Ephedra major	Trees and shrubs
Lilium martagon	Herbs
Trinia	Herbs
Campanula rapunculoides	Herbs
Lactuca-type	Herbs
Chelidonium majus	Herbs
Potamogeton nodosus	Aquatics
Valeriana tripteris	Herbs
Sanguisorba major	Herbs
Phragmites australis	Herbs
Scirpus	Helophytes
Polygonum norvegicum	Herbs
Trifolium arvense	Herbs
Thymus	Herbs
Bupleurum ranunculoides	Herbs
Pulmonaria officinalis	Herbs
Rubia	Herbs
Valerianella campestris	Herbs
Betula humilis	Dwarf shrubs
Betula tortuosa	Trees and shrubs
Krascheninnikovia ceratoides	Herbs
Kochia laniflora	Herbs
Salsola kali	Herbs
Huperzia arctica	Vascular cryptogams (Pteridophytes)
Lentibulariaceae	Helophytes
Atriplex nudicaulis	Herbs
Atriplex hastata	Herbs
Atriplex kuzenevae	Herbs
Atriplex sagittata	Herbs
Atriplex praecox	Herbs
Chenopodium hybridum	Herbs
Chenopodium polyspermum	Herbs
Chenopodium rubrum	Herbs
Kochia prostrata	Herbs
Salicornia europaea	Herbs
Woodsia undiff.	Vascular cryptogams (Pteridophytes)
Typha minima	Helophytes
Juncaginaceae	Aquatics
Sagittaria sagittifolia	Helophytes
Diphasiastrum tristachyum	Vascular cryptogams (Pteridophytes)
Adoxa	Herbs
Utricularia minor	Aquatics
Dryopteris cristata	Vascular cryptogams (Pteridophytes)
Lycopodium obscurum	Vascular cryptogams (Pteridophytes)
Lycopodium lagopus	Vascular cryptogams (Pteridophytes)
Hepaticeae	Bryophytes
Asplenium viride	Vascular cryptogams (Pteridophytes)
Dryopteris fragrans	Vascular cryptogams (Pteridophytes)
Dryopteris crassirhizoma	Vascular cryptogams (Pteridophytes)
Suaeda maritima	Herbs
Utricularia vulgaris	Aquatics
Pinus pumila	Trees and shrubs
Rhizomatopteris sudetica	Vascular cryptogams (Pteridophytes)
Abies sibirica	Trees and shrubs
Ribes nigrum	Trees and shrubs
Betula costata	Trees and shrubs
Vaccinium uliginosum	Dwarf shrubs
Betula fruticosa	Dwarf shrubs
Betula alba/B. fruticosa	Trees and shrubs
Ulmus pumila	Trees and shrubs
Rutaceae	Trees and shrubs
Caragana	Trees and shrubs
Stellera	Trees and shrubs
Kochia	Herbs
cf. Platanus	Indeterminables and unknowns
cf. Lonicera	Indeterminables and unknowns
cf. Centaurea scabiosa-type	Herbs
cf. Succisa	Indeterminables and unknowns
Fumana-type	Dwarf shrubs
Colchicum autumnale-type	Herbs
Polygonum oxyspermum	Herbs
cf. Sedum-type	Indeterminables and unknowns
cf. Armeria	Herbs
cf. Olea	Indeterminables and unknowns
cf. Daphne	Indeterminables and unknowns
cf. Centaurea nigra-type	Herbs
cf. Reseda lutea-type	Indeterminables and unknowns
Guttiferae	Herbs
cf. Anagallis-type	Indeterminables and unknowns
cf. Viscum	Indeterminables and unknowns
Dryopteris undiff.	Vascular cryptogams (Pteridophytes)
cf. Cryptogramma crispa	Vascular cryptogams (Pteridophytes)
Larix sibirica	Trees and shrubs
Fraxinus undiff.	Trees and shrubs
Eucalyptus spike (counted)	Nonpollen
Concentration spikes	Nonpollen
Volume of spike added	Nonpollen
Cistus salvifolius	Trees and shrubs
Labiatae (6)	Herbs
Labiatae (3)	Herbs
Roemeria hybrida	Herbs
Zygnema/Spirogyra	Algae
Pseudoschizaea	Algae
Glomus	Fungi
Spike	Nonpollen
Verbenaceae	Herbs
Tilia platyphyllos subsp. cordifolia	Trees and shrubs
Quercus petraea	Trees and shrubs
Corylus maxima	Trees and shrubs
Woodsia ilvensis	Vascular cryptogams (Pteridophytes)
Rorippa amphibia	Herbs
Oenanthe	Herbs
Glyceria maxima	Herbs
Sium	Herbs
Potamogeton natans	Aquatics
Groenlandia densa	Aquatics
Thalictrum flavum	Herbs
Scirpus lacustris subsp. tabernaemontani	Helophytes
Potamogeton perfoliatus	Aquatics
Pteridophyta spores	Vascular cryptogams (Pteridophytes)
Potamogeton pectinatus	Aquatics
Lycopus/Mentha	Herbs
Listera	Herbs
Schoenoplectus lacturis subsp. lacustris	Helophytes
Ranunculus polyphyllus	Herbs
Veronica anagallis-aquatica	Herbs
Gypsophila repens	Herbs
Armeria maritima subsp. maritima	Herbs
Leucostegia immersa	Vascular cryptogams (Pteridophytes)
Myosoton aquaticum	Herbs
Najas marina	Aquatics
Triglochin maritima	Helophytes
Potamogeton lucens	Aquatics
Aegopodium	Herbs
Robinia pseudacacia	Trees and shrubs
Antennaria	Herbs
Abies marocana	Trees and shrubs
Cedrus atlantica	Trees and shrubs
Lonicera implexa	Trees and shrubs
Polygala-type	Herbs
Eryngium ilicifolium	Herbs
cf. Arbutus	Dwarf shrubs
Centaurium maritimum	Herbs
Argania spinosa	Trees and shrubs
Cannabaceae/Urticaceae	Herbs
Carlina-type	Herbs
Ceratonia siliqua	Trees and shrubs
Cistus monspeliensis	Trees and shrubs
Corrigiola	Herbs
Genista/Ulex	Trees and shrubs
Halimium	Herbs
Lygeum spartum	Herbs
Plantago albicans	Herbs
Plantago psyllium-type	Herbs
Polycarpon	Herbs
Cistus populifolius-type	Trees and shrubs
Zizyphus lotus	Trees and shrubs
Armeria alliacea	Herbs
Fraxinus angustifolia subsp. oxycarpa	Trees and shrubs
Cistus incanus-type	Trees and shrubs
Erica scoparia-type	Dwarf shrubs
Hypnum	Bryophytes
Betula humilis/B. nana	Dwarf shrubs
Mentha longifolia	Herbs
Ceratophyllaceae	Vegetative microfossils
Woodsia	Vascular cryptogams (Pteridophytes)
Chenopodium undiff.	Herbs
Alnus incana subsp. kolaensis	Trees and shrubs
Acer negundo-type	Trees and shrubs
Astragalus/Oxytropis	Herbs
Fungal spore	Fungi
Paris/Gagea	Herbs
Gladiolus/Romulea	Herbs
Glaucium flavum-type	Herbs
Larix/Pseudotsuga	Trees and shrubs
Ligustrum vulgare-type	Trees and shrubs
Linum usitatissimum/L. bienne	Herbs
Matteuccia struthiopteris	Vascular cryptogams (Pteridophytes)
Pisum sativum	Herbs
Psylliostachys spicata	Herbs
Zelkova abelicea	Trees and shrubs
Adiantum capillus-veneris	Vascular cryptogams (Pteridophytes)
Sparganiaceae/Typhaceae	Helophytes
cf. Sambucus racemosa	Trees and shrubs
cf. Sambucus nigra	Trees and shrubs
Galium boreale	Herbs
Galium verum	Herbs
Chara	Macrofossils
Tuberaria lignosa	Herbs
Cistus ladanifer	Trees and shrubs
Pinus laricio	Trees and shrubs
Allium suaevolens	Herbs
Erica terminalis	Dwarf shrubs
Lygeum	Herbs
Sanguisorba minor-type	Herbs
Spermatophyta	Indeterminables and unknowns
Spermatophyta, upland herbs	Indeterminables and unknowns
Rosaceae trees	Trees and shrubs
Pinus cembra/Pinus haploxylon-type	Trees and shrubs
Hippophae: hairs	Vegetative microfossils
Centaurea cf. C. cyanus-type	Herbs
Centaurea cf. C. nigra-type	Herbs
Centaurea cf. C. scabiosa-type	Herbs
cf. Acorus	Indeterminables and unknowns
cf. Alchemilla	Indeterminables and unknowns
cf. Armeria (type A)	Herbs
cf. Baldellia	Indeterminables and unknowns
cf. Cedrus	Trees and shrubs
cf. Centaurium	Herbs
cf. Myrtus	Indeterminables and unknowns
cf. Polygonum	Indeterminables and unknowns
cf. Polygonum amphibium	Indeterminables and unknowns
Lygeum-type	Herbs
Acanthaceae	Herbs
Aegopodium podagraria	Herbs
Alnus viridis-type	Trees and shrubs
Alnus glutinosa-type	Trees and shrubs
Astrantia major-type	Herbs
Cabombaceae	Pre-Quaternary type
Cucurbitaceae	Herbs
Dorycnium	Herbs
Eryngium	Herbs
Galanthus-type	Herbs
Geranium pratense-type	Herbs
Moehringia trinervia-type	Herbs
Illecebrum-type	Herbs
Lactuca sativa-type	Herbs
Cichorium intybus-type	Herbs
Laurus nobilis	Trees and shrubs
Liriodendron tulipiferum	Pre-Quaternary type
Aizoaceae	Herbs
Portulacaceae	Herbs
Osmunda regalis-type	Vascular cryptogams (Pteridophytes)
Hamamelidaceae	Trees and shrubs
Polygala vulgaris-type	Herbs
Psoralea bituminosa	Herbs
Pterocarya fraxinifolia	Trees and shrubs
Cystopteris montana-type	Vascular cryptogams (Pteridophytes)
Ribes alpinum	Trees and shrubs
Ricinus communis	Trees and shrubs
Sonchus oleraceus-type	Herbs
Spartium junceum	Trees and shrubs
Staphylea pinnata	Trees and shrubs
Theligonum cynocrambe	Herbs
Ulmus/Zelkova	Trees and shrubs
Valeriana dioica-type	Herbs
Valeriana tripteris-type	Herbs
Zizyphus	Trees and shrubs
Viburnum lantana-type	Trees and shrubs
Pinus halepensis-type	Trees and shrubs
Chrysophyceae	Algae
Quercus ilex/Q. coccifera	Trees and shrubs
Hypecoum-type	Herbs
Chamaerops	Trees and shrubs
Myrtus/Eucalyptus	Trees and shrubs
Fumana	Dwarf shrubs
Sarcopoterium spinosum/Sanguisorba minor	Trees and shrubs
Carpinus orientalis/Ostrya carpinifolia	Trees and shrubs
Galega-type	Herbs
Dorycnium-type	Herbs
Plantago holosteum-type	Herbs
Plantago lagopus-type	Herbs
Polycnemum	Herbs
Trilete spores (roughly verrucate)	Vascular cryptogams (Pteridophytes)
Trilete spores (smoothly verrucate)	Bryophytes
Filicinae	Vascular cryptogams (Pteridophytes)
Lycopodium spike (added)	Nonpollen
Lycopodium spike (counted)	Nonpollen
Sarcopoterium	Trees and shrubs
Ammi	Herbs
Angelica palustris-type	Herbs
Angelica sylvestris	Herbs
Anthemis (small)-type	Herbs
Anthriscus sylvestris	Herbs
Arenaria	Herbs
Berula erecta	Helophytes
Carum verticillatum	Herbs
Chaerophyllum temulentum	Herbs
Cistus ladanifer-type	Trees and shrubs
Conium maculatum	Herbs
Dianthus lusitanicus-type	Herbs
Fraxinus angustifolia	Trees and shrubs
Gagea soleirolii	Herbs
Gentiana lutea/Pneumonanthe	Herbs
Halimium/Tuberaria	Herbs
Lamium	Herbs
Laserpitium	Herbs
Lavandula-type	Trees and shrubs
Lychnis/Silene elegans	Herbs
Lythrum undiff.	Herbs
Merendera pyrenaica	Herbs
Meum-type	Herbs
Minuartia recurva	Herbs
Ornithopus	Herbs
Paronychia polygonifolia-type	Herbs
Physospermum cornubiense	Herbs
Pimpinella anisum	Herbs
Plantago coronopus sensu stricto	Herbs
Plantago radicata-type	Herbs
Reseda/Sesamoides	Herbs
Rhinanthus/Veronica	Herbs
Sarothamnus grandiflorus	Trees and shrubs
Selinum carvifolia	Herbs
Seseli libanotis-type	Herbs
Silaum silaus-type	Herbs
Silene foetida-type	Herbs
Torilis arvensis-type	Herbs
Trinia glauca-type	Herbs
Viburnum tinus	Trees and shrubs
Alnus viridis subsp. suaveolens	Trees and shrubs
Lamiastrum	Herbs
Sparganium (monad)	Helophytes
Sparganium (tetrad)	Helophytes
Grammitis	Vascular cryptogams (Pteridophytes)
Sesamoides	Herbs
Symphytum officinale	Herbs
Plantago officinalis	Herbs
Selaginella selaginoides-type	Vascular cryptogams (Pteridophytes)
Alnus glutinosa/A. incana	Trees and shrubs
Centaurea collina-type	Herbs
Cytisus-type	Trees and shrubs
Cerealia-type/Secale	Herbs
Tetraclinis	Trees and shrubs
Tuberaria	Herbs
Weight	Nonpollen
Analysed lines	Nonpollen
Polygonum alpinum-type	Herbs
Drosera undiff.	Helophytes
Epilobium undiff.	Herbs
Zea undiff.	Herbs
cf. Humulus lupulus	Herbs
Pteridaceae	Vascular cryptogams (Pteridophytes)
Characeae	Macrofossils
Picea sect. Eupicea	Trees and shrubs
Eriocaulaceae	Helophytes
Renium	Indeterminables and unknowns
Najas	Aquatics
Nymphaea tetragona	Aquatics
Podocarpus	Trees and shrubs
cf. Rhamnaceae	Indeterminables and unknowns
cf. Primulaceae	Indeterminables and unknowns
cf. Cannabaceae	Indeterminables and unknowns
cf. Liliaceae	Indeterminables and unknowns
Olea-type	Trees and shrubs
Carpinus cf. C. betulus	Trees and shrubs
Quercus cf. Q. robur	Trees and shrubs
Quercus cf. Q. ilex	Trees and shrubs
Centaurea cf. C. scabiosa	Herbs
cf. Sanguisorba	Indeterminables and unknowns
cf. Aizoon	Indeterminables and unknowns
cf. Osmunda	Vascular cryptogams (Pteridophytes)
Pinus pinaster-type	Trees and shrubs
Pinus nigra-type	Trees and shrubs
Cupressaceae-type	Trees and shrubs
Quercus cf. Q. suber	Trees and shrubs
Sorbus aucuparia-type	Trees and shrubs
Erica multiflora-type	Dwarf shrubs
Rhus coriaria	Trees and shrubs
Sideritis (4)	Herbs
Nerium oleander	Trees and shrubs
Rubus ulmifolius-type	Trees and shrubs
Atractylis	Herbs
Ephedra distachya/E. nebrodensis	Trees and shrubs
Scrophularia canina-type	Herbs
Verbascum pulverulentum-type	Herbs
Anchusa azurea-type	Herbs
Asphodelus fistulosus	Herbs
Sarcocapnos	Herbs
Blackstonia perfoliata-type	Herbs
Andropogon	Dwarf shrubs
Portulaca oleracea-type	Herbs
Lysimachia ephemerum	Herbs
Agrimonia eupatoria	Herbs
Anchusa azurea	Herbs
Conium-type	Herbs
Galium aparine	Herbs
Pellaea-type	Vascular cryptogams (Pteridophytes)
cf. Adiantum	Vascular cryptogams (Pteridophytes)
Tilletia caries-type	Fungi
Tecaphora-type	Fungi
Puccinia	Fungi
Chaetomium	Fungi
Dyadosporites	Pre-Quaternary type
Pluricellasporites	Pre-Quaternary type
Fusiformisporites	Pre-Quaternary type
Microthyrium-type	Fungi
Sordariaceae	Fungi
Polyadosporites	Pre-Quaternary type
Riccia lamellosa-type	Bryophytes
Acaulon-type	Bryophytes
Mougeotia-type	Algae
Closterium idiosporum-type	Algae
Rivularia	Cyanobacteria
Gloeotrichia	Cyanobacteria
Trichuris	Nematoda (roundworms)
Closterium idiosporum	Algae
Closterium cf. C. rostratum	Algae
Alnus pro parte	Trees and shrubs
Dryopteris dilatata-type	Vascular cryptogams (Pteridophytes)
Pinus mugo	Trees and shrubs
Counted exote	Nonpollen
Pinus pro parte	Trees and shrubs
Added exote (grains/ml)	Nonpollen
Pediastrum angulosum var. laevigatum	Algae
Potamogeton subg. Coleogeton-type	Aquatics
Aruncus-type	Herbs
Amphitrema wrightianum	Rhizopods
Arcella artocrea	Rhizopods
Arcella catinus	Rhizopods
Arcella gibbosa	Rhizopods
Cochlopodium vestitum	Rhizopods
Hyalosphenia cf. H. elegans	Rhizopods
Hyalosphenia subflava	Rhizopods
Nebela parvula	Rhizopods
Nephelis	Hirudinea (leeches)
Spirulina	Algae
Trigonopyxis arcula	Rhizopods
Cymbaria daurica	Herbs
Pyrola minor	Dwarf shrubs
Pyrola incarnata	Dwarf shrubs
Patrinia	Herbs
Goniolimon	Herbs
Chamaenerion undiff.	Herbs
Celtis-type	Trees and shrubs
Echinops-type	Herbs
Crocus longiflorus	Herbs
Adenostyles	Herbs
Anarrhinum bellidifolium	Herbs
Astragalus lusitanicus-type	Herbs
Atropa-type	Herbs
Betula alba-type	Trees and shrubs
Calligonum-type	Trees and shrubs
Carpobrotus	Herbs
Caryophyllaceae (5 colpae)	Indeterminables and unknowns
Centaurea collina	Herbs
Centaurea sphaerocephala	Herbs
Centaurium pulchellum	Herbs
cf. Cassiope	Dwarf shrubs
cf. Phragmites australis	Herbs
cf. Rhynchospora alba	Indeterminables and unknowns
Chaerophyllum hirsutum-type	Herbs
Cicendia-type	Herbs
Cistus albidus-type	Trees and shrubs
Cistus monspeliensis-type	Trees and shrubs
Cistus psilosepalus	Trees and shrubs
Concentration pollen	Nonpollen
Conopodium majus	Herbs
Cornus-type	Trees and shrubs
Coronilla-type	Herbs
Cosmarium	Algae
Dipcadi-type	Herbs
Dryopteris filix-femina	Vascular cryptogams (Pteridophytes)
Erica erigena	Dwarf shrubs
Erica scoparia	Dwarf shrubs
Falcaria vulgaris	Herbs
Fraxinus/Phillyrea	Trees and shrubs
Fumana ericoides	Herbs
Halimium halimifolium-type	Herbs
Halimium lasianthum-type	Herbs
Helianthemum croceum-type	Herbs
Heliotropium europaeum	Herbs
Influx	Nonpollen
Lactuceae	Herbs
Levisticum officinale-type	Herbs
Ludwigia palustris	Helophytes
Lycopodiella	Vascular cryptogams (Pteridophytes)
Monocolpate	Herbs
Monocotyledone monocolpate	Herbs
Neatostema apulum	Herbs
Oryza-type	Herbs
Parentucellia-type	Herbs
Pinaceae	Trees and shrubs
Pinguicula-type	Herbs
Pinus pinea-type	Trees and shrubs
Pseudognaphalium luteo-alba-type	Herbs
Reseda media-type	Herbs
Rheum officinalis	Herbs
Ribes-type	Trees and shrubs
Rubus arcticus	Trees and shrubs
Rubus cf. arcticus	Trees and shrubs
Saxifraga adscendens	Herbs
Selaginella denticulata-type	Vascular cryptogams (Pteridophytes)
Sesamoides canescens-type	Herbs
Thorella verticillatinundata-type	Herbs
Torilis nodosa-type	Herbs
Trachystemon orientalis-type	Herbs
Trientalis-type	Herbs
Urtica/Humulus	Herbs
Peucedanum palustre	Herbs
Arctium lappa	Herbs
Carya tomentosa	Trees and shrubs
Carya tomentosa-type	Trees and shrubs
Carya glabra-type	Trees and shrubs
Haplophyllum-type	Herbs
Helleborus-type	Herbs
Lobeliaceae	Helophytes
Phyteuma	Herbs
Hyoscyamus niger	Herbs
Hypericaceae	Herbs
Taxodium	Trees and shrubs
Reynoutria	Herbs
cf. Pterocarya	Indeterminables and unknowns
Aesculus hippocastanum	Trees and shrubs
Paris	Herbs
Other trees and shrubs	Indeterminables and unknowns
Other herbs	Indeterminables and unknowns
Poaceae	Herbs
Quercus calliprinos	Trees and shrubs
Rhododendron ponticum	Dwarf shrubs
Asteroideae	Herbs
Cichorioideae	Herbs
Apiaceae	Herbs
Fabaceae	Herbs
Lamiaceae	Herbs
Menyanthes	Helophytes
Brassicaceae	Herbs
Zea	Herbs
Calluna	Dwarf shrubs
Fumariaceae	Herbs
Coryloideae	Trees and shrubs
Erica-type	Dwarf shrubs
Empetrum nigrum-type	Dwarf shrubs
Apiaceae undiff.	Herbs
cf. Anthriscus caucalis	Herbs
cf. Daucus carota	Herbs
Lactucoideae	Herbs
Chamaenerion	Herbs
Limonium vulgare	Herbs
Batrachium-type	Aquatics
Ranunculus aquatilis-type	Aquatics
Thalictrum alpinum-type	Herbs
Thalictrum flavum-type	Herbs
Lycopodium clavatum/Diphasium	Vascular cryptogams (Pteridophytes)
Diphasiastrum alpinum	Vascular cryptogams (Pteridophytes)
Typha angustifolia/Sparganium-type	Helophytes
Cerealia	Herbs
Littorella	Aquatics
Cladium	Helophytes
Parnassia	Herbs
Bistorta vivipara	Herbs
Cirsium/Carduus-type	Herbs
Geranium sylvaticum-type	Herbs
Valeriana sambucifolia-type	Herbs
Diphasiastrum	Vascular cryptogams (Pteridophytes)
Cannabaceae undiff.	Herbs
Cerastium cerastoides-type	Herbs
Silene nutans-type	Herbs
Silene acaulis-type	Herbs
Nymphaeaceae: star cell	Vegetative microfossils
Nymphaea: hairs	Vegetative microfossils
Ranunculus ficaria	Herbs
Concentration of spike	Nonpollen
Weight of tablets	Nonpollen
Caryophyllaceae subf. Silenoideae-type	Herbs
Chamaenerion angustifolium-type	Herbs
Chamaenerion angustifolium	Herbs
Papilionaceae	Herbs
Monolete fern spores	Vascular cryptogams (Pteridophytes)
Fungal spores	Fungi
Pediastrum boryanum var. boryanum	Algae
Algae	Algae
Pediastrum boryanum var. longicorne	Algae
Cerastium arvense-type	Herbs
Pediastrum duplex var. rugolosum	Algae
Cynoglossum officinale-type	Herbs
Eupatorium	Herbs
Polygonum convolvulus-type	Herbs
Orlaya	Herbs
Orlaya grandiflora	Herbs
Copepoda	Microcrustaceans
Rotatoria: ovum	Rotifera (Rotifers)
Helicoon pluriseptatum	Fungi
Microthyriaceae fruitbody	Fungi
Thecaphora	Fungi
Scabiosa argentea-type	Herbs
Clavatum-type/Diphasium	Vascular cryptogams (Pteridophytes)
Tragopogon	Herbs
Tragopogon-type	Herbs
Polygonum convolvulus	Herbs
Epilobium cf. E. angustifolium	Herbs
Plantago major/P. media-type	Herbs
Dryopteris thelypteris	Vascular cryptogams (Pteridophytes)
Schoenoplectus-type	Helophytes
Pediastrum boryanum var. brevicorne	Algae
Pediastrum obtusum	Algae
Pediastrum taylori	Algae
Pediastrum boryanum var. complanatum	Algae
Ranunculus acer	Herbs
Lycopodium selago	Vascular cryptogams (Pteridophytes)
Batrachium	Aquatics
Labiatae-type/Lycopus	Herbs
Humulus lupulus-type	Herbs
Hepatica nobilis-type	Herbs
cf. Ledum	Dwarf shrubs
Dryopteris spinulosa	Vascular cryptogams (Pteridophytes)
Rumex acetosa/R. acetosella	Herbs
cf. Carduus	Herbs
Dryopteris-type: sporangia	Vegetative microfossils
Polypodiaceae: sporangia	Vegetative microfossils
Poaceae undiff.	Herbs
Fabaceae undiff.	Herbs
Rumex acetosa-type/Oxyria	Herbs
Comarum palustre	Herbs
Syringa vulgaris	Trees and shrubs
cf. Xanthium-type	Indeterminables and unknowns
Nymphaeaceae idioblast	Vegetative microfossils
Rubus cf. chamaemorus	Indeterminables and unknowns
Polygonum cf. amphibium	Aquatics
Cuscuta lupuliformis	Herbs
Filicales monoletes	Vascular cryptogams (Pteridophytes)
Pediastrum privum	Algae
Hippophae rhamnoides: hairs	Vegetative microfossils
Montia perfoliata	Herbs
Sisymbrium	Herbs
Helianthemum/Gentiana pneumonanthe	Indeterminables and unknowns
Indeterminable: obscured	Indeterminables and unknowns
Emex spinosa	Herbs
cf. Dryas octopetala	Trees and shrubs
cf. Empetrum	Dwarf shrubs
Rosa canina-type	Trees and shrubs
cf. Ligustrum vulgare	Indeterminables and unknowns
Actaea spicata-type	Herbs
Cirsium cf. C. vulgare	Herbs
cf. Linum catharticum-type	Herbs
Veronica cf. spicata	Herbs
cf. Veronica chamaedrys	Herbs
Cirsium cf. C. oleraceum	Herbs
Cirsium cf. C. palustre	Herbs
cf. Lychnis viscaria-type	Herbs
cf. Lycopodiella inundatum	Vascular cryptogams (Pteridophytes)
Urtica cf. U. pilulifera	Herbs
Cirsium cf. C. arvense	Herbs
Polygonum hydropiper-type	Herbs
Polygonum persicaria-group	Herbs
cf. Scleranthus annuus	Herbs
Apiaceae cf. Berula erecta	Herbs
cf. Primula farinosa	Indeterminables and unknowns
Bryales: leaves	Macrofossils
Carex: rootlet	Macrofossils
cf. Malus	Trees and shrubs
Anemone nemorosa-group	Herbs
Papaveraceae undiff.	Herbs
Ranunculus acris-group	Herbs
Cirsium acaule	Herbs
Pulsatilla vulgaris-group	Herbs
Trifolium badium-type	Herbs
Trifolium spadiceum-type	Herbs
Ranunculus ficaria-group	Herbs
Veronica chamaedrys	Herbs
Oenanthe fistulosa-type	Herbs
Peplis portula	Herbs
cf. Cuscuta europea	Indeterminables and unknowns
Veronica officinalis	Herbs
Nymphaeaceae: leaf hairs base	Vegetative microfossils
Nymphaeaceae: trichosclereid	Vegetative microfossils
Ceratophyllum: spines	Vegetative microfossils
Pinus subg. Pinus	Trees and shrubs
Carum carvi	Herbs
Consolida-type	Herbs
Melandrium	Herbs
Minuartia rubra-type/Bufonia	Herbs
Minuartia rubra-type	Herbs
Rumex alpinus	Herbs
Torilis arvensis	Herbs
Typhaceae/Sparganiaceae	Helophytes
Sparganium angustifolium-type	Helophytes
Ceratophyllum: macroremains	Macrofossils
Fungal: remains	Fungi
Cercophora-type	Fungi
Nymphaeaceae: macroremains	Vegetative microfossils
Hepatophyta	Bryophytes
Nymphaeaceae: trichoblasts	Vegetative microfossils
Pediastrum angulosum var. angulosum	Algae
Pediastrum boryanum var. cornutum	Algae
Podospora-type	Fungi
Sporormiella-type	Fungi
Sporormiella	Fungi
Tetraploa	Fungi
Ustulina deusta	Fungi
Cannabis/Humulus	Herbs
Aethusa cynapium	Herbs
Agrostemma	Herbs
Asteraceae	Herbs
Astrantia major	Herbs
Bellidiastrum-type	Herbs
Blechnum	Vascular cryptogams (Pteridophytes)
Bryidae	Bryophytes
Carum carvi-type	Herbs
Cichoriaceae	Herbs
Cryptogramma	Vascular cryptogams (Pteridophytes)
Cyphoderia ampulla	Invertebrates
Meum athamanticum	Herbs
Panicum-type	Herbs
Pastinaca sativa	Herbs
Pennales	Algae
Lythrum peplis	Herbs
Peplis	Herbs
Phaeoceros laevis	Bryophytes
Scandix pecten-veneris	Herbs
Silaum silaus	Herbs
Torilis japonica	Herbs
Myricaria germanica-type	Trees and shrubs
Angelica sylvestris-type	Herbs
Anthriscus caucalis-type	Herbs
Asteraceae undiff.	Herbs
Centaurium pulchellum-type	Herbs
Colchicum autumnale	Herbs
Eryngium campestre-type	Herbs
Falcaria vulgaris-type	Herbs
Onopordum acanthium	Herbs
Papaver argemone-type	Herbs
Sagina procumbens	Herbs
Torilis japonica-type	Herbs
Chaerophyllum hirsutum	Herbs
Eryngium campestre	Herbs
Gratiola officinalis	Herbs
Lamiaceae undiff.	Herbs
Onobrychis viciifolia	Herbs
Sambucus nigra/S. racemosa	Trees and shrubs
Cerastium fontanum	Herbs
Linum undiff.	Herbs
Polygonum romanum-type	Herbs
Sphagnum: leaves	Macrofossils
Lithospermum arvense	Herbs
Myricaria-type	Trees and shrubs
Lamium album	Herbs
Morus nigra	Trees and shrubs
Boraginaceae undiff.	Herbs
Lycopodium alpinum-type	Vascular cryptogams (Pteridophytes)
Blepharisma	Invertebrates
Juncus: seed epidermis	Vegetative microfossils
Nicotiana	Herbs
Adonis annua-type	Herbs
Carlina	Herbs
Astragalus depressus	Herbs
Cyclamen purpurascens	Herbs
Cyperus-type	Helophytes
Buphthalmum	Herbs
Hedysarum hedysaroides	Herbs
Onosma	Herbs
Lloydia serotina	Herbs
Rumex triangulivalvis	Herbs
Soldanella	Herbs
Geranium phaeum-type	Herbs
Quercus cerris/Q. suber	Trees and shrubs
Prunus/Sorbus	Trees and shrubs
Crupina-type	Herbs
Carduncellus-type	Herbs
Asparagus acutifolius	Herbs
Epipactis palustris-type	Herbs
Gagea/Tulipa	Herbs
Helleborus foetidus	Herbs
Plantago maritima/P. serpentina	Herbs
Phyllitis scolopendrium-type	Vascular cryptogams (Pteridophytes)
Berberis vulgaris-type	Trees and shrubs
Carpinus betulus-type	Trees and shrubs
Ulmus-type	Trees and shrubs
Cardueae	Herbs
Malva/Lavatera	Herbs
Malva sylvestris-type	Herbs
Cephalanthera longifolia-type	Herbs
Drosera intermedia-type	Helophytes
Rivularia-type	Cyanobacteria
Ceterach officinarum	Vascular cryptogams (Pteridophytes)
Quercus ilex/Q. coccifera-type	Trees and shrubs
Minuartia-type	Herbs
Meliola niessleana	Fungi
Neurospora	Fungi
Cytinus	Herbs
Cytinus hypocistis	Herbs
Aristolochia paucinervis-type	Herbs
Paronychia argentea-type	Herbs
Ophioglossum vulgatum-type	Vascular cryptogams (Pteridophytes)
Anthemideae	Herbs
Carduaceae	Herbs
Grossulariaceae	Trees and shrubs
Glomus cf. fasciculatum	Fungi
Circaea-type	Herbs
Cistus-type	Trees and shrubs
Viscum album-type	Trees and shrubs
Armeria/Limonium-type	Herbs
Dipsacus fullonum-type	Herbs
Urtica pilulifera	Herbs
Trachycarpus	Trees and shrubs
Stomata	Vegetative microfossils
Rosa/Prunus	Trees and shrubs
Poterium	Trees and shrubs
Rubus idaeus	Trees and shrubs
Endymion	Herbs
Lycopodium alpinum	Vascular cryptogams (Pteridophytes)
Cistus-type undiff.	Trees and shrubs
Lavandula	Trees and shrubs
Lavandula stoechas-type	Trees and shrubs
Pseudoschizaea circula	Algae
Pleospora	Fungi
Alternaria	Fungi
Buxus sempervirens-type	Trees and shrubs
Daphne gnidium-type	Dwarf shrubs
Frangula alnus-type	Trees and shrubs
Ribes nigrum-type	Trees and shrubs
Globularia	Herbs
Globularia alypum-type	Herbs
Lemna minor-type	Aquatics
Nuphar lutea-type	Aquatics
Asplenium-type undiff.	Vascular cryptogams (Pteridophytes)
Asplenium trichomanes	Vascular cryptogams (Pteridophytes)
Riccardia pinguis-type	Bryophytes
Coniochaeta	Fungi
Coniochaeta cf. C. ligniaria	Fungi
Hystrichosphaeropsis	Dinoflagellates
Convolvulus arvensis-type	Herbs
Utricularia vulgaris-type	Aquatics
Fagopyrum esculentum-type	Herbs
Quantity of sample	Nonpollen
Quantity of spike	Nonpollen
Number of spike added	Nonpollen
Volume or mass examined	Nonpollen
Total concentration	Nonpollen
Ranunculus sect. Batrachium	Aquatics
Corylus avellana-type	Trees and shrubs
Pteropsida undiff.	Vascular cryptogams (Pteridophytes)
Lycopodium alpinum/complanatum	Vascular cryptogams (Pteridophytes)
Solidago virgaurea-type	Herbs
cf. Astragalus glycyphyllos	Indeterminables and unknowns
Silene dioica	Herbs
Isoetes echinospora	Aquatic Pteridophyta
Gentianella detonsa	Herbs
Lastrea phegopteris	Vascular cryptogams (Pteridophytes)
Isoetes cf. I. lacustris	Aquatic Pteridophyta
Acer negundo	Trees and shrubs
Ulmus campestris	Trees and shrubs
Sparganium/Typha	Helophytes
Coriaria	Trees and shrubs
Ranunculus lanuginosus	Herbs
Stellaria holostea-type	Herbs
Cyperus capitatus	Helophytes
Ophioglossum lusitanicum-type	Vascular cryptogams (Pteridophytes)
Ophioglossum lusitanicum	Vascular cryptogams (Pteridophytes)
Chironomidae	Invertebrates
Ranunculus batrachium	Aquatics
Osmunda	Vascular cryptogams (Pteridophytes)
Osmundaceae	Vascular cryptogams (Pteridophytes)
Cardueae undiff.	Herbs
Cerealia-type/Triticum	Herbs
Daucaceae	Herbs
Silenaceae	Herbs
Humulus/Cannabis-type	Herbs
Viciaceae	Herbs
Lycopodium cf. L. complanatum	Vascular cryptogams (Pteridophytes)
Potentilla/Comarum	Herbs
Vacciniaceae	Dwarf shrubs
Valeriana cf. V. officinalis	Herbs
Viola canina-type	Herbs
Ephedraceae	Trees and shrubs
Juniperus/Cupressaceae	Trees and shrubs
Ulmaceae	Trees and shrubs
Acanthus-type	Herbs
Anisosciadium	Herbs
Bifora radians-type	Herbs
Ferula/Bunium-type	Herbs
Turgenia	Herbs
Arceuthobium	Trees and shrubs
Carthamus-type	Herbs
Gundelia	Herbs
Gundelia-type	Herbs
Centaurea dealbata-type	Herbs
Pinaceae: reworked	Trees and shrubs
Bongardia-type	Trees and shrubs
Cerinthe minor-type	Herbs
Cynoglossum creticum-type	Herbs
Heliotropium	Herbs
Phacelia	Herbs
Phacelia tanacetifolia-type	Herbs
Dianthus/Petrorhagia	Herbs
Minuartia verna-type	Herbs
Cuscuta gronovii-type	Herbs
Frankenia-type	Herbs
Gladiolus-type	Herbs
Iridaceae undiff.	Herbs
Leontice	Herbs
Tulipa	Herbs
Limonium vulgare-type	Herbs
Atraphaxis-type	Trees and shrubs
Pteropyrum-type	Herbs
Rheum ribes	Herbs
Ranunculus constantinopolitanus-type	Herbs
Ranunculus muricatus-type	Herbs
Ranunculus nivalis-type	Herbs
Rumex acris-type	Indeterminables and unknowns
Rumex alpinus-type	Herbs
Rhus-type	Trees and shrubs
Amygdalus-type	Trees and shrubs
Typha minima-type	Helophytes
Zannichelliaceae	Aquatics
Zannichellia	Aquatics
Zannichellia-type	Aquatics
Characeae: oospores	Macrofossils
Aconitum-group	Herbs
Fagonia	Herbs
Fagonia-type	Herbs
Leontice-type	Herbs
Actaea spicata	Herbs
Fallopia-type	Herbs
Ranunculus asiaticus	Herbs
Concentration of marker	Nonpollen
Adonis aestivalis-type	Herbs
Alkanna-type	Herbs
Liliiflorae	Herbs
Xanthium spinosum-type	Herbs
Andrachne telephioides	Trees and shrubs
Androsace elongata-type	Herbs
Angelica archangelica	Herbs
Angelica palustris	Herbs
Arenaria serpyllifolia-type	Herbs
Salvinia-type	Aquatic Pteridophyta
Betula pubescens-type	Trees and shrubs
Polygonum (tricolporate)	Herbs
Polygonum convolvulus/P. dumetorum	Herbs
Blackstonia perfoliata	Herbs
Buglossoides-type	Herbs
Triticum/Avena-type	Herbs
Achillea/Aster-type	Herbs
Typha/Sparganium-type	Helophytes
Statice	Herbs
Trilete fern spores	Vascular cryptogams (Pteridophytes)
Homogyne-type	Herbs
Homogyne	Herbs
Ligusticum mutellina	Herbs
Primula hirsuta-type	Herbs
Sarothamnus scoparius	Trees and shrubs
Trifolium alpinum-type	Herbs
Lycopodium (spores/tablet)	Nonpollen
Lycopodium tablets (number)	Nonpollen
Doronicum	Herbs
Moehringia-type	Herbs
Medicago falcata-type	Herbs
Seseli-type	Herbs
Arnica-type	Herbs
Tussilago farfara	Herbs
Helianthemum alpestre-type	Herbs
Pollen, cf. upland herbs	Indeterminables and unknowns
Chaerophyllum-type	Herbs
Aethusa-type	Herbs
Laserpitium latifolium-type	Herbs
Helianthus	Herbs
Sium latifolium-type	Herbs
Sample dry mass (g)	Nonpollen
Sample surface (cm²)	Nonpollen
Anthriscus cerefolium	Herbs
Aconitum napellus-type	Herbs
Juglans nigra	Trees and shrubs
Rumex alpestris	Herbs
Selinum carvifolia/pyrenaeum	Herbs
Taraxacum officinale-group	Herbs
Type 114	Macrofossils
Type 140	Fungi
Ulmus glabra-type	Trees and shrubs
Cannabis/Humulus-type	Herbs
Anemone nemorosa/A. ranunculoides	Herbs
Anthriscus nitida/sylvestris	Herbs
Betula pendula/pubescens	Trees and shrubs
Carduus/Cirsium	Herbs
Geranium pratense-group	Herbs
Hordeum vulgare-type	Herbs
Hypericum perforatum-group	Herbs
Knautia arvensis-type	Herbs
Lysimachia terrestris/thyrsiflora	Herbs
Moehringia trinervia-group	Herbs
Narthecium ossifragum-type	Herbs
Papaver dubium	Herbs
Pimpinella major/P. saxifraga	Herbs
Quercus robur-group	Trees and shrubs
Ranunculus aconitifolius	Herbs
Ranunculus flammula-group	Helophytes
Saponaria	Herbs
Saponaria officinalis	Herbs
Silene vulgaris-group	Herbs
Sphagnum-type	Vascular cryptogams (Pteridophytes)
Tilia cordata/platyphyllos	Trees and shrubs
Vitaceae	Trees and shrubs
Vitis sylvestris/vinifera	Trees and shrubs
Cerastium fontanum-group	Herbs
Cuscuta europaea	Herbs
Lathyrus/Vicia	Herbs
Laserpitium prutenicum	Herbs
Rumex sanguineus	Herbs
Rumex palustris-type	Herbs
Ammi-type	Herbs
Anethum-type	Herbs
Falcaria-type	Herbs
Trinia glauca	Herbs
Coelastrum	Algae
Lycopodium inundatum	Vascular cryptogams (Pteridophytes)
Hippocrepis comosa	Herbs
Potamogeton subg. Eupotamogeton-type	Aquatics
Taxus baccata: stomata	Vegetative microfossils
Athamanta cretensis	Herbs
Lycopodium complanatum	Vascular cryptogams (Pteridophytes)
Lonicera alpigena	Trees and shrubs
Deposition time (yr/cm)	Nonpollen
Rosaceae tree	Trees and shrubs
Ammi majus	Herbs
Cyclamen hederifolium	Herbs
Foeniculum vulgare subsp. vulgare	Herbs
Vincetoxicum	Herbs
Trichothyrium	Fungi
Ranunculus lingua-type	Herbs
Mineral particles >20µm	Nonpollen
Turgenia latifolia	Herbs
Lonicera coerulea	Trees and shrubs
Holosteum umbellatum	Herbs
Ligusticum mutellinoides-type	Herbs
Rhododendron, scale	Macrofossils
Geum montanum-type	Herbs
Paradisia liliastrum	Herbs
Comarum-type	Herbs
Pediastrum duplex var. duplex	Algae
Pediastrum simplex var. simplex	Algae
Pediastrum boryanum var. boryanum sensu lato	Algae
Pediastrum duplex var. rugulosum	Algae
Reworked pollen	Pre-Quaternary type
Coniferae undiff.	Trees and shrubs
Epimedium	Herbs
Myrrhis odorata	Herbs
Diphasiastrum complanatum-type	Vascular cryptogams (Pteridophytes)
Trilete psilate	Vascular cryptogams (Pteridophytes)
Thalictrum aquilegiifolium	Herbs
Pinus non-cembra	Trees and shrubs
Solidago virgaurea	Herbs
Artemisia campestris	Herbs
Deschampsia	Herbs
Thalictrum minus-type	Herbs
Thalictrum minus	Herbs
Aconitum non-napellus	Herbs
Crepis paludosa	Herbs
Crepis aurea	Herbs
Andryala-type	Herbs
Hieracium murorum	Herbs
Hieracium pilosella	Herbs
Hieracium intybaceum	Herbs
Leontodon-type	Herbs
Leontodon helveticus	Herbs
Leontodon hispidus	Herbs
Hypochaeris uniflora	Herbs
Pimpinella major	Herbs
Peucedanum ostruthium	Herbs
Astrantia minor	Herbs
Prenanthes purpurea	Herbs
Rhododendron-type	Dwarf shrubs
Rhododendron ferrugineum	Dwarf shrubs
Silene nutans	Herbs
Leucanthemum vulgare-type	Herbs
Trifolium alpinum	Herbs
Trifolium badium	Herbs
Trifolium pallescens	Herbs
Potentilla grandiflora	Herbs
Carlina acaulis	Herbs
Minuartia sedoides	Herbs
Sagina saginoides	Herbs
Salix helvetica-type	Trees and shrubs
Salix retusa-type	Trees and shrubs
Artemisia genipi/A. mutellina	Herbs
Chrysanthemum alpinum	Herbs
Homogyne alpina	Herbs
Cirsium spinosissimum	Herbs
Ranunculus montanus-type	Herbs
Gentianella germanica-type	Herbs
Gentianella ramosa	Herbs
Potentilla aurea	Herbs
Campanula barbata	Herbs
Phyteuma hemisphaericum	Herbs
Minuartia verna	Herbs
Aster bellidiastrum	Herbs
Cerastium uniflorum	Herbs
Epilobium fleischeri	Herbs
Achillea moschata	Herbs
Silene rupestris	Herbs
Gnaphalium supinum	Herbs
Soldanella pusilla	Herbs
Alchemilla pentaphylla	Herbs
Cerastium cerastoides	Herbs
Arenaria biflora	Herbs
Trichophorum caespitosum	Helophytes
Eriophorum angustifolium/E. vaginatum	Helophytes
Eriophorum scheuchzeri	Helophytes
Poa/Festuca-type	Herbs
Anthoxanthum	Herbs
Nardus	Herbs
Avena versicolor	Herbs
Alnus non-viridis	Trees and shrubs
Ranunculus glacialis-type	Herbs
Ranunculus glacialis	Herbs
Cornus undiff.	Trees and shrubs
Diphasiastrum complanatum	Vascular cryptogams (Pteridophytes)
Fagopyrum undiff.	Herbs
Thalictrum undiff.	Herbs
Thalictrum lucidum	Herbs
Cornus subg. Kraniopsis	Trees and shrubs
Agrostemma-type	Herbs
Lythraceae undiff.	Herbs
Convolvulaceae undiff.	Herbs
Acer platanoides	Trees and shrubs
Hepaticae	Bryophytes
Anthocerotales (type 1)	Bryophytes
Anthocerotales (type 2)	Bryophytes
Anthocerotales (type 3)	Bryophytes
Combretaceae	Trees and shrubs
Liliopsida monocolpate	Herbs
Typha cf. T. domingensis	Helophytes
Azolla nilotica	Aquatic Pteridophyta
Mimusops	Dwarf shrubs
Ocimum	Herbs
Peristrophe	Herbs
Peristrophe cf. P. bicalyculata	Herbs
Typha cf. T. elephantina	Helophytes
Chenopodiaceae/Amaranthaceae undiff.	Herbs
Pinaceae undiff.	Trees and shrubs
Aerva	Herbs
Acer undiff.	Trees and shrubs
Betula sect. Betula	Trees and shrubs
Sison amomum	Herbs
Torilis nodosa	Herbs
Levisticum officinale	Herbs
Pollen, cf. upland herbs undiff.	Indeterminables and unknowns
Convallaria majalis	Herbs
Saxifraga paniculata-type	Herbs
Streptopus amplexifolius	Herbs
Helleborus viridis	Herbs
Silene pratensis	Herbs
Rhaponticum scariosum	Herbs
Glyceria	Herbs
Hordelymus	Herbs
Pulmonaria obscura	Herbs
Diphasiastrum-type	Vascular cryptogams (Pteridophytes)
Dryopteris cf. D. cristata	Vascular cryptogams (Pteridophytes)
Calluna vulgaris: stomata	Vegetative microfossils
Sorbus aria-type	Trees and shrubs
Hordeum/Triticum-type	Herbs
Mentha/Thymus-type	Herbs
Polemonium coeruleum	Herbs
cf. Calluna: stomata	Vegetative microfossils
Coniferae: stomata	Vegetative microfossils
Capparaceae	Trees and shrubs
Caesalpinia-type	Trees and shrubs
Hagenia abyssinica	Trees and shrubs
Hyphaene	Trees and shrubs
Hyphaene cf. H. thebaica	Trees and shrubs
Randia	Trees and shrubs
Sapotaceae	Trees and shrubs
Cardiospermum	Herbs
Cardiospermum cf. C. halicacabum	Herbs
Ophioglossum cf. O. polyphyllum	Vascular cryptogams (Pteridophytes)
Syzygium-type	Trees and shrubs
Laboratory number	Nonpollen
Pirus-type	Trees and shrubs
Tozzia alpina	Herbs
Onopordum	Herbs
Setaria	Herbs
Helianthemum alpestre	Herbs
Plantago montana	Herbs
Centaurea jacea/C. scabiosa	Herbs
Umbelliferae/Apiaceae	Herbs
Filipendula cf. F. ulmaria	Herbs
Polygonum minus-type	Herbs
Cytisus/Genista-type	Trees and shrubs
Genista/Cytisus-type	Trees and shrubs
Vicia/Lathyrus-type	Herbs
Arcella-type	Rhizopods
Plantago sp.	Herbs
Pinaceae pro parte	Trees and shrubs
Androsaceae	Herbs
Anemone/Pulsatilla	Herbs
Filicales	Vascular cryptogams (Pteridophytes)
Hedysarum humile-type	Herbs
Dryas	Herbs
Amphitrema flavum-type	Rhizopods
Assulina-type	Rhizopods
Potentilla erecta	Herbs
Polygonum sp.	Herbs
Asperula	Herbs
Comarum	Herbs
Plantago alpinus	Herbs
Parnassia/Nuphar	Indeterminables and unknowns
Anemone/Pulsatilla-type	Herbs
Plantago intermedia-type	Herbs
Salvia officinalis-type	Herbs
Rosmarinus	Trees and shrubs
Pinus maritima	Trees and shrubs
Meum	Herbs
Botryococcus (5)	Algae
Botryococcus (10)	Algae
Botryococcus (50)	Algae
Drepanocladus: leaves	Macrofossils
Juniperus communis: stomata	Vegetative microfossils
Onosma/Echium-type	Herbs
Volume of sample (cm3)	Nonpollen
Volume of spike (number tablets)	Nonpollen
Asteraceae Liguliflorae	Herbs
Asteraceae Tubuliflorae	Herbs
Concentration of Lycopodium	Nonpollen
Sedimentation rate (mm/year)	Nonpollen
Varve by sample	Nonpollen
Poaceae pro parte	Herbs
Ranunculaceae pro parte	Herbs
Fabaceae pro parte	Herbs
Caryophyllaceae pro parte	Herbs
Rosaceae pro parte	Trees and shrubs
Ranunculus acer-type	Herbs
Asteroideae pro parte	Herbs
Melampyrum pratense	Herbs
Euphorbia cf. E. palustris	Herbs
Liliaceae pro parte	Herbs
Lamiaceae pro parte	Herbs
Polypodiaceae pro parte	Vascular cryptogams (Pteridophytes)
Ballota-type	Herbs
Stachys sylvatica	Herbs
Brassicaceae undiff.	Herbs
Poaceae undiff. <40µm	Herbs
Poaceae undiff. >40µm	Herbs
Hornungia	Herbs
Charcoal <25µm	Charcoal
Charcoal >25µm	Charcoal
Liguliflorae	Herbs
Tubuliflorae	Herbs
Poaceae large	Herbs
Mounted volume (0.001 ml)	Nonpollen
Sample number	Nonpollen
Number of counted lines	Nonpollen
Total number of lines	Nonpollen
Size of cover glass (mm)	Nonpollen
Volume of residue (ml)	Nonpollen
Hedera-type	Trees and shrubs
Robinia	Trees and shrubs
Morus alba	Trees and shrubs
Verbena-type	Herbs
Rumex palustris-group	Herbs
Ustulina	Fungi
Fallopia	Herbs
Myriophyllum-type	Aquatics
Hieracium-type	Herbs
Erica: seed epidermis	Vegetative microfossils
Juncus: seed	Macrofossils
Juncus effusus-type: seed	Macrofossils
cf. Peucedanum	Herbs
Maianthemum/Paris	Herbs
Salvia-type	Herbs
Viscum album sensu lato	Trees and shrubs
Viola tricolor-type	Herbs
Conium maculatum-type	Herbs
Pimpinella saxifraga	Herbs
Saponaria officinalis-type	Herbs
Sium erectum-type	Herbs
Aethusa cynapium-type	Herbs
Carum	Herbs
Caucalis platycarpos	Herbs
Foeniculum vulgare	Herbs
Lamium album-type	Herbs
Meum athamanticum-type	Herbs
Ruta graveolens	Trees and shrubs
Scrophulariaceae pro parte	Herbs
Pteridophyta: sporangia	Vegetative microfossils
Berula erecta-type	Helophytes
Datura stramonium	Herbs
Juncus squarrosus: seed	Macrofossils
Aphanes	Herbs
Ballota	Herbs
Campanula trachelium-type	Herbs
Chaenorhinum minus	Herbs
Descurainia sophia	Herbs
Callitriche stagnalis	Aquatics
Callitriche stagnalis-type	Aquatics
Phlomis-type	Herbs
Fabaceae/Lathyrus-type	Herbs
Oenotheraceae	Herbs
Fabaceae/Lotus-type	Herbs
Fabaceae/Onobrychis-type	Herbs
Wet weight (g)	Nonpollen
Tilia: stomata	Vegetative microfossils
Alnus: stomata	Vegetative microfossils
Cryptomeria-type	Trees and shrubs
Cryptomeria	Trees and shrubs
Foraminifera	Invertebrates
Statice limonium	Herbs
Fagus: leaves	Macrofossils
Adenostyles-type	Herbs
Fungi	Fungi
Type 571	Fungi
Ephedra alata	Trees and shrubs
Quercus cf. Q. rotundifolia	Trees and shrubs
Quercus cf. Q. canariensis	Trees and shrubs
Cedrus cf. C. atlantica	Trees and shrubs
Cistus cf. C. salvifolius	Trees and shrubs
Rumex sanguineus-type	Herbs
Salvia pratensis-group	Herbs
Rosmarinus-type	Trees and shrubs
Pulsatilla-type	Herbs
Caryophyllaceae indeterminata	Herbs
Ranunculaceae indeterminata	Herbs
Rosaceae indeterminata	Trees and shrubs
Filicinae undiff.	Vascular cryptogams (Pteridophytes)
Fabaceae indeterminata	Herbs
Consolida ambigua	Herbs
Indeterminata	Indeterminables and unknowns
Quercus robur/Q. pubescens-type	Trees and shrubs
Quercus pubescens	Trees and shrubs
Cotinus	Trees and shrubs
cf. Allium vineale-type	Herbs
Linum sp.	Herbs
Scilla	Herbs
Compositae indeterminata	Herbs
Dipsaceae indeterminata	Herbs
Euphorbiaceae undiff.	Herbs
Liliaceae indeterminata	Herbs
Linaceae undiff.	Herbs
Plantago indeterminata	Herbs
Indeterminata/Varia	Indeterminables and unknowns
Pediastrum campanulatum	Algae
Botryococcus neglectus	Algae
Viola riviniana/V. canina	Herbs
Viola riviniana	Herbs
cf. Samolus	Indeterminables and unknowns
Aphanes-type	Herbs
Araliaceae	Trees and shrubs
Araliaceae indeterminata	Trees and shrubs
Phaeoceros	Bryophytes
Tilia indeterminata	Trees and shrubs
Polygonum hydropiper	Herbs
Alchemilla arvensis	Herbs
Rumex/Eurumex-type	Herbs
Cerealia indeterminata	Herbs
Potamogeton natans-type	Aquatics
Potamogeton eupotamogeton-type	Aquatics
Ranunculus batrachium-type	Aquatics
Sambucus ebulus-type	Trees and shrubs
Dryopteris austriaca	Vascular cryptogams (Pteridophytes)
Dryopteris linnaeana	Vascular cryptogams (Pteridophytes)
Trilete spores (verrucate)	Bryophytes
Asteraceae subf. Asteroideae undiff.	Herbs
Asteraceae subf. Cichorioideae undiff.	Herbs
Fraxinus angustifolia-type	Trees and shrubs
Quercus deciduous-type	Trees and shrubs
Quercus evergreen-type	Trees and shrubs
Quercus pubescens/Q. robur-type	Trees and shrubs
Quercus deciduous	Trees and shrubs
Orlaya-type	Herbs
Aruncus/Spiraea	Herbs
Spiraea-type	Trees and shrubs
Exotic concentration	Nonpollen
Exotic	Nonpollen
Typha/Sparganium	Helophytes
Achillea/Matricaria	Herbs
Bellis/Senecio	Herbs
Labiatae cf. Scutellaria	Herbs
Lysimachia/Anagallis	Herbs
Rosaceae reticulate-type	Herbs
Rosaceae/Potentilla	Herbs
Consolida regalis-type	Herbs
Coniferae (vesiculate)	Trees and shrubs
Laserpitium latifolium	Herbs
Centaurea sinaica	Herbs
Lycopus/Mentha longifolia	Herbs
Ostrya carpinifolia	Trees and shrubs
Scandix pecten-veneris-type	Herbs
Selinum carvifolia-type	Herbs
Linum alpinum-type	Herbs
Teucrium chamaedrys-type	Herbs
Teucrium chamaedrys	Herbs
Ericales indeterminata	Dwarf shrubs
Marker (added)	Nonpollen
Compositae subf. Asteroideae indeterminata	Herbs
Anchusa arvensis-type	Herbs
Copepoda: spermatophors	Microcrustaceans
Viola odorata-type	Herbs
Marker (counted)	Nonpollen
Triloculina frigida	Rhizopods
Valeriana sambucifolia	Herbs
Helianthemum alpinum	Herbs
Sparganium sp.	Helophytes
Lychnis flos-cuculi-type	Herbs
Salvia verticillata	Herbs
Saxifraga oppositifolia-group	Herbs
Vicia tetrasperma	Herbs
Juncus effusus: seed	Macrofossils
Juncus articulatus-type: seed	Macrofossils
Juncus acutiflorus/J. articulatus: seed	Macrofossils
Apium graveolens	Herbs
Chaerophyllum hirsutum/C. temulentum	Herbs
Conium	Herbs
Euphorbia exigua	Herbs
Gentiana cruciata	Herbs
Geranium robertianum-type	Herbs
Geranium robertianum/G. rotundifolium	Herbs
Portulaca oleracea	Herbs
Reseda luteola	Herbs
Origanum/Thymus	Herbs
Alnus indeterminata	Trees and shrubs
Lycopodium indeterminata	Vascular cryptogams (Pteridophytes)
Pinus indeterminata	Trees and shrubs
Rumex sp.	Herbs
Urtica indeterminata	Herbs
Betula indeterminata	Trees and shrubs
Filicales triletes	Vascular cryptogams (Pteridophytes)
Filicales triletes undiff.	Vascular cryptogams (Pteridophytes)
Filicales monoletes undiff.	Vascular cryptogams (Pteridophytes)
Ephedra intermedia-type	Trees and shrubs
Ephedra major-type	Trees and shrubs
Bryonia-type	Herbs
Moltkiopsis-type	Herbs
Limonium-type	Herbs
Callidina	Rotifera (Rotifers)
Ranunculus indeterminata	Herbs
Plantago alpina/P. maritima	Herbs
Fabaceae/Trifolium-type	Herbs
cf. Tamarix	Indeterminables and unknowns
Pteranthus	Herbs
Lathyrus filiformis	Herbs
Polygonum aquatic	Aquatics
Classopollis	Pre-Quaternary type
Symphoricarpos	Trees and shrubs
Amelanchier	Trees and shrubs
Cachrys-type	Herbs
Polygonum amplexicaule	Herbs
Cucumis	Herbs
Cucumis melo	Herbs
Chrozophora-type	Herbs
Chrozophora	Herbs
Scabiosa palestina	Herbs
Coris	Herbs
Croton tinctorium	Herbs
Corydalis pumila-type	Herbs
Lathyrus/Vicia-type	Herbs
Ornithogalum umbellatum-type	Herbs
Turgenia latifolia-type	Herbs
Pedicularis verticillata-type	Herbs
Asteraceae subf. Asteroideae	Herbs
Isoetes undiff.	Aquatic Pteridophyta
Ostrya/Carpinus orientalis-type	Trees and shrubs
Rumex/Oxyria-type	Herbs
Sanguisorba/Poterium	Herbs
Calluna vulgaris-type	Dwarf shrubs
Centaurea montana/C. triumfetti	Herbs
Herniaria glabra-type	Herbs
Carpinus/Ostrya-type	Trees and shrubs
Rhamnus catharticus-type	Trees and shrubs
Crataegus monogyna-type	Trees and shrubs
Hottonia palustris-type	Aquatics
Pedicularis oederi-type	Herbs
Anarrhinum	Herbs
Apiaceae indeterminata	Herbs
Asphodelus lutea	Herbs
Castanea/Sedum	Indeterminables and unknowns
Cerealia/Secale	Herbs
Cistus indeterminata	Trees and shrubs
Cistus populifolius	Trees and shrubs
Daphne gnidium	Dwarf shrubs
Erica indeterminata	Dwarf shrubs
Fumana thymifolia	Herbs
Halimium halimifolium	Herbs
Plantaginaceae indeterminata	Herbs
cf. Primula	Indeterminables and unknowns
Quercus indeterminata	Trees and shrubs
Reseda luteola-type	Herbs
Reseda-type	Herbs
Smilax aspera	Herbs
Labiatae (tricolpate)	Herbs
Stachys glutinosa-type	Herbs
Trifolium hybridum-type	Herbs
Ulex/Cytisus-type	Trees and shrubs
Apium inundatum	Herbs
Bidens sensu lato	Herbs
Erica cinerea/E. ciliaris	Dwarf shrubs
Tuberaria guttata	Herbs
Pteropsida monolete undiff.	Vascular cryptogams (Pteridophytes)
Sporomorphs	Taxonomically undifferentiated spores
Quercus canariensis	Trees and shrubs
Isoete spore(s)	Aquatic Pteridophyta
Ericaceae pro parte	Dwarf shrubs
Betulaceae pro parte	Trees and shrubs
Helianthemum pro parte	Herbs
Cyperaceae pro parte	Helophytes
Myriophyllum indeterminata	Aquatics
Pinaceae indeterminata	Trees and shrubs
Potentilla indeterminata	Herbs
Bryonia dioica	Herbs
Prunella vulgaris-type	Herbs
Morus-type	Trees and shrubs
cf. Lithospermum	Indeterminables and unknowns
Pediastrum spp.	Algae
Redeposited pollen	Pre-Quaternary type
Trilete spores (reworked)	Pre-Quaternary type
Indeterminable: hidden	Indeterminables and unknowns
Concentricystes	Algae
Iridaceae/Amaryllidaceae	Herbs
Phlomis cf. fruticosa	Herbs
Ranunculus acer/R. repens	Herbs
Aquatics	Indeterminables and unknowns
Bryophytes	Bryophytes
Chlorophyta	Algae
Cyanobacteria	Cyanobacteria
Chara: hairs	Vegetative microfossils
Eumycota	Fungi
Fungus	Fungi
Erica: seed	Macrofossils
Herbs	Indeterminables and unknowns
Hirudinea (leeches)	Hirudinea (leeches)
Indeterminables and unknowns	Indeterminables and unknowns
Lonicera cf. periclymenum	Trees and shrubs
Macrofossils	Indeterminables and unknowns
Microcrustaceans	Microcrustaceans
Nematoda (roundworms)	Nematoda (roundworms)
Humulus/Cannabis <26µm	Herbs
Platyhelminthes (flatworms)	Platyhelminthes (flatworms)
Pre-Quaternary type	Pre-Quaternary type
Rhizopods	Rhizopods
Rotifera (Rotifers)	Rotifera (Rotifers)
Taxonomically undiff. spores	Taxonomically undifferentiated spores
Trees and shrubs	Indeterminables and unknowns
Humulus/Cannabis >26µm	Herbs
Vascular cryptogams (Pteridophytes)	Indeterminables and unknowns
Mesozoic: reworked	Pre-Quaternary type
Dodonaea	Trees and shrubs
Daphne-type	Dwarf shrubs
Fumaria-type	Herbs
Potentilla micrantha-type	Herbs
Plantago maritima-type sensu lato	Herbs
Plantago maritima-type sensu stricto	Herbs
Lycopodium cf. L. selago	Vascular cryptogams (Pteridophytes)
Lycopodium sp.	Vascular cryptogams (Pteridophytes)
Centaurea sp.	Herbs
cf. Cistus	Indeterminables and unknowns
Compositae pro parte	Herbs
Polygonum pro parte	Herbs
Plantago pro parte	Herbs
Varia/Indeterminable	Indeterminables and unknowns
Cystopteris indeterminata	Vascular cryptogams (Pteridophytes)
Agrimonia eupatoria-type	Herbs
Arctium lappa-type	Herbs
Ballota nigra-type	Herbs
Empetrum/Ledum	Dwarf shrubs
Eupatorium cannabinum-type	Herbs
Larix decidua-type	Trees and shrubs
Omphalodes-type	Herbs
Urtica/Parietaria	Herbs
Viburnum opulus/V. tinus	Trees and shrubs
Genista/Ulex-type	Trees and shrubs
Sordaria-type	Fungi
Sordaria sp.	Fungi
Chaetomium sp.	Fungi
Podospora sp.	Fungi
Type 18	Fungi
Type 90	Fungi
Gelasinospora sp.	Fungi
Cercophora	Fungi
Sporormiella sp.	Fungi
Type 4	Fungi
Coniochaeta xylariispora	Fungi
Type 6	Fungi
Pleospora-type	Fungi
Pleospora sp.	Fungi
Type 359	Fungi
Quercus faginea	Trees and shrubs
Damasonium	Helophytes
Rumex conglomeratus	Herbs
Linum maritimum-type	Herbs
Fedia	Herbs
Selaginella denticulata	Vascular cryptogams (Pteridophytes)
Myriophyllum alterniflorum-type	Aquatics
Polygonum hydrolapathum-type	Herbs
Fraxinus xanthoxyloides-type	Trees and shrubs
Polygonatum odoratum-type	Herbs
Ruscus	Trees and shrubs
Solanum sodomeum	Herbs
Simethis	Herbs
Sambucus/Viburnum-type	Trees and shrubs
Polycarpon-type	Herbs
Typha (tetrad)	Helophytes
Odontites/Euphrasia	Herbs
Veronica/Reseda	Indeterminables and unknowns
Parthenocissus quinquefolia	Trees and shrubs
Draba	Herbs
Gaeumannomyces	Fungi
Mycodalyelia armigera	Fungi
Lithospermum arvense-type	Herbs
Centaurea alpina-type	Herbs
Sparganium/Typha angustifolia-type	Helophytes
Chenopodiaceae sensu lato	Herbs
Ericaceae sensu lato	Dwarf shrubs
Plantago media/P. montana-type	Herbs
Potentilla/Comarum-type	Herbs
Cerealia (excl. Secale)	Herbs
Scleranthus cf. S. annuus	Herbs
Scleranthus cf. S. perennis	Herbs
Sparganium/Typha angustifolia	Helophytes
Anthoceros punctatus-type	Bryophytes
Lepidoptera	Invertebrates
Sponge	Invertebrates
Vermes	Invertebrates
cf. Ustulina deusta	Fungi
Type 201	Fungi
Type 224	Undifferentiated NPP
Chironomidae: labium	Invertebrates
Chrysomonads	Invertebrates
Rotifera undiff.	Rotifera (Rotifers)
Rotifera/Tardigrada: ovum	Invertebrates
Actinopeltis	Fungi
Type 31A	Rhizopods
cf. Entophlyctis lobata	Fungi
cf. Type 10	Fungi
cf. Type 77B	Fungi
Lasiosphaeria cf. caudata	Fungi
Lasiosphaeria-like ascospores	Fungi
Lasiosphaeria undiff.	Fungi
Type 8A	Fungi
Neurospora sp.	Fungi
Type 1	Fungi
Type 10	Fungi
Type 11	Fungi
Type 124	Fungi
Type 16A	Fungi
Type 16B	Fungi
Type 16C	Fungi
Type 17	Fungi
Type 19	Fungi
Type 20	Fungi
Type 200	Fungi
Type 23	Fungi
Type 24	Fungi
Type 33	Undifferentiated NPP
Type 35	Dinoflagellates
Type 353A	Platyhelminthes (flatworms)
Type 353B	Platyhelminthes (flatworms)
Type 354	Bryophytes
Type 38	Undifferentiated NPP
Type 3A	Fungi
Type 41	Undifferentiated NPP
Type 47	Fungi
Type 53	Fungi
Type 55A	Fungi
Type 55B	Fungi
Type 64	Fungi
Type 73	Fungi
Type 74	Undifferentiated NPP
Type 77A	Fungi
Type 77B	Fungi
Type 83	Fungi
Type 86	Undifferentiated NPP
Type 8B	Fungi
Type 8E	Fungi
Type 91	Undifferentiated NPP
Type 93	Fungi
Type 98	Fungi
Rotatoria	Rotifera (Rotifers)
Tardigrada	Invertebrates
Ascomycetes	Fungi
Tertiary spores	Pre-Quaternary type
Cicatricosporites australiensis	Pre-Quaternary type
Microthyrium microscopicum	Fungi
Normapolles	Pre-Quaternary type
Botryococcus undiff.	Algae
Fungi sp.	Fungi
Hydrodictyon	Algae
Scenedesmus armatus	Algae
Tetraedron undiff.	Algae
Desmidiales	Algae
Pediastrum sp.	Algae
Scenedesmus sp.	Algae
Staurastrum sp.	Algae
Microthyrium undiff.	Fungi
Lasiosphaeria	Fungi
Botryococcus cf. B. terribilis	Algae
Tertiary exotes	Pre-Quaternary type
Lycopodium tablets	Nonpollen
Cretaceous sporomorphs	Pre-Quaternary type
Spirogyra: zygospores	Algae
Tardigrada: ovum	Invertebrates
Trichuris trichiura	Nematoda (roundworms)
Ascaris lumbricoides	Nematoda (roundworms)
Type 8D	Fungi
Type 366	Undifferentiated NPP
Invertebrata	Invertebrates
Amphitrema sp.	Rhizopods
Arcella cf. A. megastoma	Rhizopods
Centropyxis	Algae
Difflugia	Rhizopods
Hyalosphenia papilio	Rhizopods
Pyxidicula	Rhizopods
Rhizopoda indeterminata	Rhizopods
Macrobiotus	Invertebrates
Macrobiotus cf. echinogenitus	Invertebrates
Assulina sp.	Rhizopods
Gaeumannomyces sp.	Fungi
Geoglossum sphagnophilum	Fungi
Phegopteris dryopteris	Vascular cryptogams (Pteridophytes)
Closterium	Algae
Hepatica nobilis	Herbs
Phegopteris	Vascular cryptogams (Pteridophytes)
Myriophyllum heterophyllum	Aquatics
Athyrium-type	Vascular cryptogams (Pteridophytes)
Pediastrum boryanum var. longicorne/alternans	Algae
Pediastrum duplex var. subgranulatum	Algae
Cerealia sp.	Herbs
Tilia sp.	Trees and shrubs
Saxifraga sp.	Herbs
Tertiary species	Pre-Quaternary type
Myriophyllum sp.	Aquatics
Gyratrix hermaphroditus	Platyhelminthes (flatworms)
Saxifragaceae undiff.	Herbs
Nymphaea undiff.	Aquatics
Tertiary Pinus	Pre-Quaternary type
Gentiana sp.	Herbs
Malus sp.	Trees and shrubs
Prunus sp.	Trees and shrubs
Ascaris	Nematoda (roundworms)
Habrotrocha angusticollis	Rotifera (Rotifers)
Cerealia-type (excl. Secale)	Herbs
Pediastrum simplex var. echinulatum	Algae
Filinia longiseta	Rotifera (Rotifers)
Chlamydomonadina	Algae
Type 119	Undifferentiated NPP
Type 351	Fungi
Type 179	Invertebrates
Type 3B	Fungi
Type 27	Fungi
Type 28	Invertebrates
Type 36	Invertebrates
Type 52	Undifferentiated NPP
Type 63C	Fungi
Type 71	Invertebrates
Type 72	Microcrustaceans
Type 88	Invertebrates
Type 112	Fungi
Type 113	Fungi
Type 116A	Acritarchs
Type 165	Bryophytes
Type 166A	Algae
Type 172	Fungi
Type 183	Undifferentiated NPP
Type 207	Fungi
Type 313C	Algae
Type 313D	Algae
Type 353	Platyhelminthes (flatworms)
Type 356	Algae
Podospora	Fungi
Type 527	Fungi
Type 711	Algae
Type 900	Algae
Type 901	Algae
Type 600	Algae
Type 30	Fungi
Type 148	Undifferentiated NPP
Type 5	Fungi
Type 332C	Algae
Type 332F	Algae
Type 178	Invertebrates
Type 181	Undifferentiated NPP
Type 18A	Fungi
Type 72A	Microcrustaceans
Type 82	Fungi
Type 107	Invertebrates
Type 115	Acritarchs
Type 150	Undifferentiated NPP
Type 204	Fungi
Type 209	Algae
Type 225	Algae
Type 233	Undifferentiated NPP
Type 317	Algae
Spirogyra cf. scrobiculata	Algae
Type 496	Fungi
Type 913	Invertebrates
Type 55	Fungi
Type 173	Fungi
Type 92	Fungi
Type 7A	Fungi
Type 44	Fungi
Type 66	Algae
Type 127	Macrofossils
Type 128B	Algae
Type 187	Invertebrates
Type 314	Algae
Type 229	Algae
Type 7B	Fungi
Type 206	Fungi
Plantago intermedia	Herbs
Type 6A	Fungi
Type 191	Platyhelminthes (flatworms)
Type 186	Rhizopods
Type 205	Fungi
Type 190	Hirudinea (leeches)
Riccia cf. sorocarpa	Bryophytes
Acari, Oribatei	Invertebrates
Cathaya-type	Trees and shrubs
Type 128A	Algae
Type 182	Undifferentiated NPP
Mougeotia sp.	Algae
Spirogyra undiff.	Algae
Entorrhiza	Fungi
Zopfia	Fungi
Type 174	Fungi
Type 315	Algae
Type 31	Rhizopods
Type 407	Undifferentiated NPP
Type 425	Undifferentiated NPP
Type 65	Fungi
Type 116	Acritarchs
Type 117	Fungi
Type 118	Fungi
Type 120	Fungi
Type 121	Fungi
Type 122	Fungi
Type 123	Fungi
Type 126	Fungi
Type 143	Fungi
Type 144	Fungi
Type 145	Fungi
Type 149	Undifferentiated NPP
Type 152	Fungi
Type 173A	Fungi
Type 184	Undifferentiated NPP
Type 218	Macrofossils
Type 203	Fungi
Type 303	Undifferentiated NPP
Type 304	Algae
Type 350	Fungi
Quercus evergreen	Trees and shrubs
Urticaceae undiff.	Herbs
Hystrichosphaeropsis undiff.	Dinoflagellates
Fungi amerospores undiff.	Fungi
Fungi didymospores undiff.	Fungi
Fungi tetrads undiff.	Fungi
Fungi amerospores	Fungi
Fungi polyads	Fungi
Types 181-182	Undifferentiated NPP
Neorhabdocoela undiff.	Platyhelminthes (flatworms)
Type 37	Rotifera (Rotifers)
Type 62	Algae
Type 71B	Undifferentiated NPP
Type 88A	Invertebrates
Type 175	Invertebrates
Type 568C	Fungi
Type 716	Undifferentiated NPP
Type 728	Undifferentiated NPP
Type 729	Fungi
Type 764A	Algae
Riccia sp.	Bryophytes
Charcoal <50µm	Charcoal
Charcoal >50µm	Charcoal
Type 60	Algae
Type 130	Algae
Type 131	Algae
Type 133	Algae
Type 211	Algae
Type 221	Invertebrates
Type 306	Fungi
Type 313	Algae
Type 324	Fungi
Type 342	Algae
Type 352	Rhizopods
Juniperus oxycedrus-type	Trees and shrubs
Quercus pyrenaica-type	Trees and shrubs
Pinus halepensis/P. pinea-type	Trees and shrubs
Withania	Trees and shrubs
Cosentinia	Vascular cryptogams (Pteridophytes)
Retama-type	Herbs
Pinus sylvestris/P. nigra-type	Trees and shrubs
Gentiana lutea-type	Herbs
Utricularia-type	Aquatics
Merendera montana	Herbs
Leucojum	Herbs
Merendera filifolia-type	Herbs
Sedum album-type	Herbs
Echinops ritro	Herbs
Galeopsis-Ballota-group	Herbs
Urtica dubia-type	Herbs
Artemisia alba-type	Herbs
Lathyrus montanus-type	Herbs
Athyrium filix-mas	Vascular cryptogams (Pteridophytes)
Crocus vernus	Herbs
Gagea	Herbs
Scleranthus annuus-type	Herbs
Sorbus torminalis	Trees and shrubs
Poaceae/Glyceria-type	Herbs
Scabiosa pratensis-type	Herbs
Symphytum cf. S. officinalis	Herbs
Illecebrum verticillatum	Herbs
Cerealia-type/Triticum/Avena	Herbs
Cerealia/Hordeum-type	Herbs
Cerealia/Triticum-type	Herbs
Listera ovata	Herbs
cf. Agrimonia	Indeterminables and unknowns
cf. Celtis	Indeterminables and unknowns
Knautia/Dipsacus	Herbs
Bruckenthalia-type	Dwarf shrubs
Cedrus-type	Trees and shrubs
Cerealia/Avena-type	Herbs
Cupressaceae/Taxodiaceae	Trees and shrubs
Encalypta-type	Bryophytes
Engelhardtia-type	Trees and shrubs
Magnolia-type	Trees and shrubs
Bambusa-type	Herbs
Podocarpus-type	Trees and shrubs
Rumex cf. R. alpinus	Herbs
Symplocos	Pre-Quaternary type
Tsuga diversifolia-type	Trees and shrubs
Astragalus excarpus	Herbs
Dictamnus albus	Herbs
Alnus incana/A. glutinosa	Trees and shrubs
Crassulaceae undiff.	Herbs
Hypericum perforatum/H. androsaemum-type	Herbs
Ornithopus perpusillus	Herbs
Primulaceae undiff.	Herbs
Eranthis hyemalis	Herbs
Pediastrum orientale	Algae
Potamogeton/Triglochin	Aquatics
Eranthis hyemalis-type	Herbs
Gramineae >43µm	Herbs
Matthiola-type	Herbs
Bryonia alba/Helianthemum	Indeterminables and unknowns
Impatiens-type	Herbs
Impatiens parvifolia	Herbs
Nymphoides peltata-type	Aquatics
Sagittaria-type	Helophytes
Thesium-type	Herbs
Sciadopitys-type	Trees and shrubs
Osmunda-type	Vascular cryptogams (Pteridophytes)
Osmunda claytoniana	Vascular cryptogams (Pteridophytes)
Adonis aestivalis/A. flammea	Herbs
Bistorta	Herbs
Bistorta major	Herbs
Campanula/Phyteuma	Herbs
Centaurea jacea/C. stoebe	Herbs
Consolida regalis	Herbs
Fallopia convolvulus/F. dumetorum	Herbs
Filipendula ulmaria/F. vulgaris	Herbs
Galeopsis/Ballota-type	Herbs
Glaucium corniculatum	Herbs
Papaver somniferum	Herbs
Persicaria maculosa-type	Herbs
Potentilla/Fragaria	Herbs
Ribes uva-crispa	Trees and shrubs
Scandix pecten-veneris/Caucalis platycarpos	Herbs
Securigera varia	Herbs
Fumaria officinalis-type	Herbs
Gentianella-type	Herbs
Pedicularis palustris	Herbs
Plantago media/P. montana	Herbs
Cuscuta-type	Herbs
Cuscuta epithymum	Herbs
cf. Polemonium	Indeterminables and unknowns
Coronilla varia	Herbs
cf. Helianthemum	Indeterminables and unknowns
cf. Diphasiastrum-type	Vascular cryptogams (Pteridophytes)
Stellaria cf. S. holostea	Herbs
Ditrema	Rhizopods
Charcoal/1000	Charcoal
Chenopodiaceae/Amaranthus	Herbs
Scabiosa atropurpurea-type	Herbs
Plantago major/P. minor-type	Herbs
Phaeoceros laevis-type	Bryophytes
Neorhabdocoela	Platyhelminthes (flatworms)
Narcissus-type	Herbs
Ajuga	Herbs
Urtica atrovirens	Herbs
Centaurea jacea/C. nigra-type	Herbs
Lamium amplexicaule-type	Herbs
Lamium hybridum-type	Herbs
Teucrium pyrenaicum-type	Herbs
Polygonum cognatum	Herbs
Cephalanthus	Trees and shrubs
Batrachium aquatile	Aquatics
Diphasiastrum alpinum-type	Vascular cryptogams (Pteridophytes)
Alisma-group	Helophytes
Aphanes arvensis-type	Herbs
Ballota-group	Herbs
Descurainia sophia-type	Herbs
Narcissus poeticus-type	Herbs
Potamogeton pectinatus-type	Aquatics
Sagina nodosa-group	Herbs
Vicia-type sensu stricto	Herbs
Viscaria vulgaris-type	Herbs
Nuphar: hairs	Vegetative microfossils
Salvia pratensis-type	Herbs
Type 32	Rhizopods
Type 572	Fungi
Type 13	Fungi
Araneida: claw	Invertebrates
Ascospora	Fungi
Cylindrocystis brebissonii	Algae
Pediastrum-type	Algae
Coniferae-type	Trees and shrubs
Fungi-type	Fungi
Juglandaceae-type	Trees and shrubs
Tsuga-type	Trees and shrubs
Microfossils	Indeterminables and unknowns
Parnassia-type	Herbs
Scleranthus perennis-type	Herbs
Pinus sp.	Trees and shrubs
Calicotome villosa	Trees and shrubs
Osyris alba	Trees and shrubs
Cistus villosus	Trees and shrubs
Sanguisorba/Poterium-type	Herbs
Echinodorus ranunculoides	Helophytes
Tillaea	Herbs
Alisma plantago	Helophytes
Daphne oleoides	Dwarf shrubs
Cercis	Trees and shrubs
Other trees	Indeterminables and unknowns
Rosaceae-type/Prunus	Trees and shrubs
Drosera-type	Helophytes
Vacciniaceae/Ericaceae	Dwarf shrubs
Ailanthus	Trees and shrubs
Selaginellaceae	Vascular cryptogams (Pteridophytes)
Type 10A	Fungi
Type 2	Fungi
Type 305	Fungi
Type 310	Fungi
Type 368	Fungi
Type 461	Fungi
Type 495	Fungi
Type 55C	Fungi
Type 708	Undifferentiated NPP
Type 902	Invertebrates
Redeposited Carpinus	Pre-Quaternary type
Charcoal concentration (10 ¦m pc/g)	Charcoal
Betula/Carpinus	Indeterminables and unknowns
Silene conica	Herbs
Sagina caespitosa	Herbs
Thelypteridaceae	Vascular cryptogams (Pteridophytes)
Eucalyptus spike (added)	Nonpollen
Sediment volume	Nonpollen
Solution volume	Nonpollen
Filicales undiff.	Vascular cryptogams (Pteridophytes)
Ephedra sp.	Trees and shrubs
Ephedra alata-type	Trees and shrubs
Diospyros	Trees and shrubs
Quercus sempervirens	Trees and shrubs
Parrotia persica	Trees and shrubs
Polygonum aviculare/P. bistorta-type	Herbs
Rubiaceae (6 colpae)	Herbs
Urticaceae/Moraceae	Herbs
Monolete non-psilate	Vascular cryptogams (Pteridophytes)
Trilete non-psilate	Vascular cryptogams (Pteridophytes)
Salviniaceae	Aquatic Pteridophyta
Salvinia/Azolla: massulae	Aquatic Pteridophyta
Label	Nonpollen
Pre-Quaternary sporomorphs	Pre-Quaternary type
Lycopodium cf. L. clavatum	Vascular cryptogams (Pteridophytes)
Lycopodium cf. L. alpinum	Vascular cryptogams (Pteridophytes)
Tertiary sporomorphs	Pre-Quaternary type
Cosmarium sp.	Algae
Euastrum	Algae
Staurastrum cf. gracile	Algae
Dinoflagellata undiff.: cysts	Dinoflagellates
Nymphaeaceae: trichome	Vegetative microfossils
Acroperus harpae	Microcrustaceans
Alona affinis	Microcrustaceans
Alona undiff.	Microcrustaceans
Alonella nana	Microcrustaceans
Bosmina coregoni-group	Microcrustaceans
Bosmina longirostris-group	Microcrustaceans
Bosmina undiff.	Microcrustaceans
Camptocercus rectirostris	Microcrustaceans
Chydorus sphaericus	Microcrustaceans
Daphniidae: mandibles and claws	Microcrustaceans
Eurycercus lamellatus	Microcrustaceans
Monospilus dispar	Microcrustaceans
Pleuroxus trigonellus	Microcrustaceans
Ostracoda: mandible	Microcrustaceans
Anuraeopsis fissa	Rotifera (Rotifers)
Ascomorpha	Invertebrates
Brachionus cf. B. urceolaris	Invertebrates
Conochilus natans	Rotifera (Rotifers)
Conochilus unicornis	Rotifera (Rotifers)
Coelastrum polychordum	Algae
Pediastrum bireticulatum	Algae
Pinus subg. Diploxylon-type	Trees and shrubs
Pinus subg. Haploxylon-type	Trees and shrubs
Alnus fruticosa-type	Trees and shrubs
Selaginella rupestris	Vascular cryptogams (Pteridophytes)
Azolla filiculoides: glochidia	Aquatic Pteridophyta
Apiaceae apioide-type	Herbs
Filinia	Rotifera (Rotifers)
Filinia longiseta passa/F. hofmanni	Rotifera (Rotifers)
Rotatoria: eggs	Rotifera (Rotifers)
Cladocera planktonic	Microcrustaceans
Cladocera non-planktonic	Microcrustaceans
Scenedesmus quadricauda	Algae
Cyanophyceae	Cyanobacteria
Characeae: remains	Macrofossils
Taxus: stomata	Vegetative microfossils
Alona guttata	Microcrustaceans
Pleuroxus	Microcrustaceans
Sida crystallina	Microcrustaceans
Camptocamptus: spermatophors	Microcrustaceans
Tanytarsini	Invertebrates
Staurophrya elegans	Invertebrates
Tintinnopsis lacustris	Invertebrates
Collotheca	Rotifera (Rotifers)
Conochilus hippocrepis	Rotifera (Rotifers)
Keratella quadrata	Rotifera (Rotifers)
Spores indeterminata	Indeterminables and unknowns
Picea obovata	Trees and shrubs
Alnus fruticosa	Trees and shrubs
cf. Potamogeton	Indeterminables and unknowns
Polypodiales	Vascular cryptogams (Pteridophytes)
Ilex-type	Trees and shrubs
Ericaceae indeterminata	Dwarf shrubs
Cyperaceae indeterminata	Helophytes
Gentianaceae indeterminata	Herbs
Trilete indeterminata	Vascular cryptogams (Pteridophytes)
Lycopodiaceae sp.	Vascular cryptogams (Pteridophytes)
Palaeozoic sporomorphs	Pre-Quaternary type
Alonella excisa	Microcrustaceans
Chydoridae	Microcrustaceans
Graptoleberis testudinaria	Microcrustaceans
Sididae	Microcrustaceans
Tardigrada: eggs	Invertebrates
Diatoms	Algae
Mesozoic sporomorphs	Pre-Quaternary type
Ulmus sp.	Trees and shrubs
Pollen undiff.	Indeterminables and unknowns
Poaceae >40µm	Herbs
Palynomorpha	Indeterminables and unknowns
Alnus hirsuta-type	Trees and shrubs
Aquilegia sp.	Herbs
Saxifraga hirsuta	Herbs
Bergenia crassifolia	Herbs
Iris germanica-type	Herbs
Pteridophyta monolete with perine	Vascular cryptogams (Pteridophytes)
Athyrium alpestre	Vascular cryptogams (Pteridophytes)
Asplenium ruta-muraria	Vascular cryptogams (Pteridophytes)
Selaginella apoda	Vascular cryptogams (Pteridophytes)
Huperzia	Vascular cryptogams (Pteridophytes)
Betula sect. Albae-type	Trees and shrubs
Betula sect. Nanae-type	Dwarf shrubs
Alnus sp.	Trees and shrubs
Pinus subg. Haploxylon	Trees and shrubs
Pinus subg. Diploxylon	Trees and shrubs
Huperzia selago-type	Vascular cryptogams (Pteridophytes)
Daphne cf. cneorum	Dwarf shrubs
cf. Dryopteris thelypteris	Vascular cryptogams (Pteridophytes)
Eu-Potamogeton-type	Aquatics
Rosaceae-type	Trees and shrubs
cf. Syringa sect. Ligustrina	Indeterminables and unknowns
Eucommia	Trees and shrubs
cf. Eucommia	Indeterminables and unknowns
cf. Viburnum opulus	Trees and shrubs
cf. Brasenia	Pre-Quaternary type
Keteleeria	Trees and shrubs
Convolvulus sepium-type	Herbs
Potamogeton eupotamogeton	Aquatics
cf. Larix-type	Indeterminables and unknowns
Elodea	Aquatics
Poaceae <37µm	Herbs
Myosotis arvensis	Herbs
Gentiana campestris	Herbs
Prunella vulgaris	Herbs
cf. Glyceria	Herbs
Vicia sylvatica	Herbs
Crataegus monogyna	Trees and shrubs
Tertiary pollen	Pre-Quaternary type
cf. Castanea	Indeterminables and unknowns
Geranium sanguineum	Herbs
Iris pumila	Herbs
Populus tremuloides	Trees and shrubs
Salix pentandra	Trees and shrubs
Alnus glutinosa/A. incana-type	Trees and shrubs
Picea cf. omorika	Trees and shrubs
Asteraceae-type	Herbs
cf. Vaccinium	Dwarf shrubs
Coniferae	Trees and shrubs
Corydalis lutea	Herbs
Umbilicus rupestris	Herbs
Myricaria	Trees and shrubs
Selaginella sanguinolenta	Vascular cryptogams (Pteridophytes)
Alliaria-type	Herbs
Alyssum-type	Herbs
Bunias-type	Herbs
Linnaea	Herbs
Rorippa sylvestris-type	Herbs
Pteropsida	Vascular cryptogams (Pteridophytes)
Indeterminable: unidentified	Indeterminables and unknowns
Lycopodium (counted) for charcoal	Nonpollen
Concentration charcoal	Charcoal
Charcoal 10-50¦m	Charcoal
Charcoal 50-180¦m	Charcoal
Total pollen	Indeterminables and unknowns
Charcoal 10-50¦m concentration	Charcoal
Charcoal 50-180¦m concentration	Charcoal
Charcoal <50µm concentration	Charcoal
Charcoal >50µm concentration	Charcoal
Fraxinus ornus-type	Trees and shrubs
Corrigiola litoralis	Herbs
Monolete ornamented	Vascular cryptogams (Pteridophytes)
Trilete ornamented	Vascular cryptogams (Pteridophytes)
Pre-Quaternary and Early-Quaternary	Pre-Quaternary type
Aster/Anthemis-type	Herbs
cf. Haplophyllum	Indeterminables and unknowns
cf. Anabaena	Cyanobacteria
cf. Filinia longiseta-type	Rotifera (Rotifers)
cf. Helicoon	Fungi
Mougeotia laetivirens	Algae
Puccinia-type	Fungi
Type 55A2	Fungi
Type 69	Undifferentiated NPP
Type 99	Fungi
Chaoborus flavicans	Invertebrates
Hexarthra mira	Rotifera (Rotifers)
Trichocerca cylindrica	Rotifera (Rotifers)
Araliaceae undiff.	Trees and shrubs
Asteraceae pro parte	Herbs
Sordaria	Fungi
Bryozoa: statoblasts	Invertebrates
Chironomidae: remains	Invertebrates
Insect: remains	Invertebrates
Pinaceae: stomata	Vegetative microfossils
Tardigrada M3	Invertebrates
Tardigrada M5	Invertebrates
Tardigrada M6	Invertebrates
Tardigrada undiff.	Invertebrates
Zygospore	Fungi
Pollen per unit sediment mass (/g)	Nonpollen
Fern spore undiff.	Vascular cryptogams (Pteridophytes)
Ascomorpha ovalis	Rotifera (Rotifers)
Salix sp.	Trees and shrubs
Picea omorika-type	Trees and shrubs
Rubus arcticus-type	Trees and shrubs
Centaurea nigra-type sensu lato	Herbs
Centaurea triumfetti-type	Herbs
cf. Chelidonium-type	Indeterminables and unknowns
Limonium vulgare (type A)	Herbs
Marrubium-type	Herbs
Myrrhis-type	Herbs
Nigella arvensis-type	Herbs
Petroselinum segetum-type	Herbs
Sonchus-type	Herbs
Trollius europaeus-type	Herbs
cf. Impatiens	Indeterminables and unknowns
Linum cf. hirsutum/L. viscosum	Herbs
cf. Arnoseris	Herbs
Scolopendrium	Vascular cryptogams (Pteridophytes)
Caragana-type	Trees and shrubs
Montia-type	Herbs
cf. Meconopsis	Indeterminables and unknowns
Carpinus triporat	Trees and shrubs
cf. Crambe-type	Indeterminables and unknowns
Ulmus scabra	Trees and shrubs
Botrychium biternatum	Vascular cryptogams (Pteridophytes)
Botrychium simplex	Vascular cryptogams (Pteridophytes)
cf. Butomus	Indeterminables and unknowns
cf. Koenigia	Indeterminables and unknowns
Koenigia	Herbs
Tubuliflorae proliferum	Herbs
Centaurea jacea/C. scabiosa-type	Herbs
Pulsatilla montana	Herbs
Cynareae	Herbs
Crambe-type	Herbs
Pinus sibirica-type	Trees and shrubs
Pinus pumila-type	Trees and shrubs
Betula sect. Nanae/Fruticosae-type	Dwarf shrubs
Lycopodium pungens	Vascular cryptogams (Pteridophytes)
Meesia	Bryophytes
Indeterminable: covered	Indeterminables and unknowns
Charcoal >10µm	Charcoal
Charcoal >100µm	Charcoal
Anabaena	Cyanobacteria
Wood	Macrofossils
Parthenocissus	Trees and shrubs
Plantago sempervirens	Herbs
Polygonum maculosa	Herbs
Polystichum undiff.	Vascular cryptogams (Pteridophytes)
Azolla filiculoides	Aquatic Pteridophyta
Stellaria alsine	Herbs
Swertia-type	Herbs
Ephedra indeterminata	Trees and shrubs
Linum austriacum	Herbs
Linum tenuifolium-type	Herbs
Linum tenuifolium	Herbs
Persicaria-type	Herbs
Rhinanthoideae	Herbs
Stellaria media	Herbs
Aremonia-type	Herbs
Tunica-type	Herbs
Stellaria alsine-type	Herbs
Total spore	Indeterminables and unknowns
Lycopodium appressum	Vascular cryptogams (Pteridophytes)
Lycopodium complanatum-type	Vascular cryptogams (Pteridophytes)
Polygonum arenarium	Herbs
Scrophulariaceae indeterminata	Herbs
Polystichum lonchitis	Vascular cryptogams (Pteridophytes)
Dictyomitra torquata	Invertebrates
Pterosperma	Invertebrates
Radiosperma	Invertebrates
Incertae sedis 5d	Indeterminables and unknowns
Incertae sedis 5b	Indeterminables and unknowns
Mimulus-type	Herbs
Caprifoliaceae undiff.	Trees and shrubs
Onagraceae undiff.	Herbs
Rumex/Oxyria digyna	Herbs
Polemoniaceae undiff.	Herbs
Selaginella undiff.	Vascular cryptogams (Pteridophytes)
Circaea alpina	Herbs
Montiaceae	Herbs
Claytonia	Herbs
Claytonia acutifolia	Herbs
Claytonia undiff.	Herbs
Claytoniella vassilievii	Herbs
Lycopodium juniperoideum	Vascular cryptogams (Pteridophytes)
Polygonum sect. Aconogonon	Herbs
Trachyphyllum	Bryophytes
Bryales undiff.	Bryophytes
Hepaticae undiff.	Bryophytes
Lycopodium annotinum subsp. alpestre	Vascular cryptogams (Pteridophytes)
Huperzia selago subsp. arctica-type	Vascular cryptogams (Pteridophytes)
Huperzia selago subsp. selago	Vascular cryptogams (Pteridophytes)
Polypodiophyta	Vascular cryptogams (Pteridophytes)
Epilobium latifolium	Herbs
Lycopodium annotinum subsp. annotinum	Vascular cryptogams (Pteridophytes)
Rhamnaceae undiff.	Trees and shrubs
Macrobiotus ambiguus-type	Invertebrates
Macrobiotus areolatus/M. richtersi-type	Invertebrates
Macrobiotus coronifer/M. islandicus-type	Invertebrates
Latona setifera	Microcrustaceans
Peracantha truncata	Microcrustaceans
Procladius	Invertebrates
Bosmina obtusirostris-group	Microcrustaceans
Zygnemales	Algae
Characeae: eggs fragments	Macrofossils
Moss: remains	Macrofossils
Polypodiophyta undiff.	Vascular cryptogams (Pteridophytes)
Picea undiff.	Trees and shrubs
Diphasiastrum undiff.	Vascular cryptogams (Pteridophytes)
Huperzia undiff.	Vascular cryptogams (Pteridophytes)
Spongia: needles	Invertebrates
Hyalosphenia elegans	Rhizopods
Betula sect. Nanae/Fruticosae	Dwarf shrubs
Saxifraga hieraciifolia	Herbs
Saxifraga tricuspidata	Herbs
Polygonum sect. Polygonum	Herbs
Polypodium sibiricum	Vascular cryptogams (Pteridophytes)
Menyanthaceae	Helophytes
Lycopodium inundatum-type	Vascular cryptogams (Pteridophytes)
Mercurialis cf. annua	Herbs
Azolla filiculoides: massulae	Aquatic Pteridophyta
Azolla: microspores	Aquatic Pteridophyta
Polygonum raii-type	Herbs
cf. Syringa	Indeterminables and unknowns
Cornus cf. C. sanguinea	Trees and shrubs
Elodea densa	Aquatics
Castilleja	Herbs
Sieversia-type	Herbs
Lloydia	Herbs
Selaginella borealis	Vascular cryptogams (Pteridophytes)
Allium sp.	Herbs
Azolla filiculoides: spores	Aquatic Pteridophyta
Dacrydium	Trees and shrubs
Pedicularis langsdorffii	Herbs
Picea/Pinus undiff.	Trees and shrubs
Ranunculus sp.	Herbs
Rubus sp.	Trees and shrubs
Diapensia	Dwarf shrubs
Sibbaldia	Herbs
Portulacaceae undiff.	Herbs
Spores undiff.	Indeterminables and unknowns
Phlox	Herbs
Type 16	Fungi
Pinus pinea	Trees and shrubs
Dipsacus fullonum	Trees and shrubs
Dicranaceae	Bryophytes
Betulaceae undiff.	Trees and shrubs
Herbs undiff.	Indeterminables and unknowns
Plumatella: statoblasts	Invertebrates
Polyarthra cf. remata	Rotifera (Rotifers)
Rotatoria undiff.	Rotifera (Rotifers)
Mass of sediment	Nonpollen
Eyepiece field of view	Nonpollen
Claytonia sibirica	Herbs
Huperzia petrovii	Vascular cryptogams (Pteridophytes)
Turbellaria Rhabdocoela: eggs	Platyhelminthes (flatworms)
Cladocera: remains	Microcrustaceans
Rosaceae sp.	Trees and shrubs
Typha/Sparganium undiff.	Helophytes
Cerealia-type/Zea	Herbs
Ruderal species	Indeterminables and unknowns
Claytonia arctica	Herbs
Microsphere suspension (volume added, ml)	Nonpollen
Humulus/Cannabis/Urtica	Herbs
Tilia: trichome	Vegetative microfossils
Scenedesmus bijugatum	Algae
Sialis	Invertebrates
Pleurotaenium	Algae
Tasmanales	Algae
Turbellaria: eggs	Platyhelminthes (flatworms)
cf. Polyarthra dolichoptera	Rotifera (Rotifers)
Cosmarium botrytis	Algae
Cosmarium granatum	Algae
Euastrum dubium	Algae
Rhynchotalona falcata	Microcrustaceans
Tintinnidium fluviatile	Invertebrates
cf. Polyarthra vulgaris	Rotifera (Rotifers)
Pediastrum bijuga	Algae
Daucus carota-type	Herbs
cf. Meum	Herbs
Valerianella locusta	Herbs
cf. Valerianaceae	Indeterminables and unknowns
Asplanchna priodonta	Rotifera (Rotifers)
Rhamnus alpinus	Trees and shrubs
Type 32B	Rhizopods
Type 32A	Rhizopods
Type 8	Fungi
Type 71A	Invertebrates
Globose	Indeterminables and unknowns
Type 112A/B	Fungi
Type 112C	Fungi
Type 128	Undifferentiated NPP
Type 222	Undifferentiated NPP
Type 263	Fungi
Type 340	Bryophytes
Type 357	Fungi
Type 360	Fungi
Type 463	Fungi
Type 570	Undifferentiated NPP
Ascospores undiff.	Fungi
Zygospores undiff.	Fungi
Type 61	Algae
Pteridosperma	Pre-Quaternary type
Type 169	Fungi
Type 171	Fungi
Type 261	Fungi
Type 262	Fungi
Type 353A/B	Platyhelminthes (flatworms)
Type 3	Fungi
Type 7	Fungi
Type 85	Fungi
Type 112A	Fungi
Type 65/Type 123	Fungi
Type 494	Fungi
Type 343	Fungi
Type 370	Fungi
Type 77	Fungi
Bryophytes undiff.	Bryophytes
Type 77A/B	Fungi
Type 365	Fungi
Type 725	Undifferentiated NPP
Arcella arenaria	Rhizopods
cf. Type 112	Fungi
Type 494A	Fungi
Type 782	Macrofossils
Microcharcoal	Charcoal
Aquatic NPP undiff.	Indeterminables and unknowns
Callitrichaceae	Aquatics
Androsace alpina-type	Herbs
Helleborus viridis-type	Herbs
Primula clusiana-type	Herbs
Alchemilla pentaphyllea-type	Herbs
Aristolochia clematitis	Herbs
Galanthus nivalis	Herbs
Myriophyllum epectinatum	Aquatics
Tamus	Herbs
Lathraea	Herbs
Saxifraga tridactylites	Herbs
Scrophularia aquatica	Herbs
Lingulodinium machaerophorum	Dinoflagellates
Spiniferites bulloideus	Dinoflagellates
Spiniferites bentorii	Dinoflagellates
Spiniferites membranaceus	Dinoflagellates
Spiniferites ramosus	Dinoflagellates
Operculodinium centrocarpum	Dinoflagellates
Utriculariaceae	Aquatics
Ruppia maritima	Aquatics
Pinus maritima-type	Trees and shrubs
Simethis mattiazzii	Herbs
Lingulodinium redonnensis	Dinoflagellates
Fungal spores indeterminata	Fungi
Aquatic remains unidentified	Macrofossils
Polygonum maritimum	Herbs
Platanus orientalis	Trees and shrubs
Magnoliaceae undiff.	Trees and shrubs
Alchemilla-group	Herbs
Anethum graveolens	Herbs
Asparagus officinalis-type	Herbs
Cephalanthera-type	Herbs
Coronilla varia-type	Herbs
Corydalis cava-type	Herbs
Geranium pusillum-type	Herbs
Heracleum mantegazzianum	Herbs
Legousia	Herbs
Leucojum-type	Herbs
Malva neglecta-type	Herbs
Medicago lupulina-type	Herbs
Polygala comosa-type	Herbs
Tetragonolobus maritimus	Herbs
Valeriana montana-type	Herbs
Vincetoxicum hirundinaria	Herbs
Caldesia parnassifolia	Helophytes
Coccus	Invertebrates
Bistorta-type	Herbs
Cannabinaceae	Herbs
Cannabis sativa-type	Herbs
Fumana laevipes-type/Cistus salvifolius	Herbs
Haloxylon	Trees and shrubs
Hedera helix-type	Trees and shrubs
Helianthemum nummularium-group	Herbs
Muscari neglectum-type	Herbs
Papaver rhoeas-group	Herbs
Saxifraga cuneifolia-type	Herbs
Scabiosa argentea	Herbs
Sorbus-group	Trees and shrubs
Valeriana saxatilis-type	Herbs
Artemisia: clumps	Herbs
Brassicaceae: clumps	Herbs
Chenopodiaceae: clumps	Herbs
Pinus: clumps	Trees and shrubs
Carya: reworked	Trees and shrubs
Coniferae: corroded	Trees and shrubs
Juglans: reworked	Trees and shrubs
Liquidambar: reworked	Pre-Quaternary type
Tsuga: reworked	Pre-Quaternary type
Caspidinium rugosum	Dinoflagellates
Pyxidinopsis psilata	Dinoflagellates
Spiniferites cruciformis	Dinoflagellates
Bitectatodinium tepikiense	Dinoflagellates
Spiniferites pachydermis	Dinoflagellates
Tectatodinium pellitum	Dinoflagellates
Spiniferites undiff.	Dinoflagellates
Tuberculodinium vancampoae	Dinoflagellates
Dinoflagellata undiff.	Dinoflagellates
Dinoflagellata: reworked	Dinoflagellates
Multiplico sphaeridium	Acritarchs
Cymatiosphaera	Acritarchs
Micrhystridium	Acritarchs
Parrotia persica-type	Trees and shrubs
Pinus pinea/P. halepensis	Trees and shrubs
Cardueae-type	Herbs
Juniperus/Tetraclinis-type	Trees and shrubs
Rhamnus alaternus-type	Trees and shrubs
Ruscus aculeatus	Trees and shrubs
Erodium-type	Herbs
Lavandula stoechas	Trees and shrubs
Tripterospora	Fungi
Concentration: pollen per mm3	Nonpollen
Sporangia	Vegetative microfossils
Viburnum sp.	Trees and shrubs
Helianthemum sp.	Herbs
Valeriana sp.	Herbs
Pediastrum boryanum var. boryanum (type 1)	Algae
Pediastrum boryanum var. boryanum (type 2)	Algae
Pediastrum orientale (type 1)	Algae
Pediastrum orientale (type 2)	Algae
Lycopodium (counted) for Pediastrum	Nonpollen
Convolvulus sepium	Herbs
cf. Cleome	Indeterminables and unknowns
Persicaria amphibia	Aquatics
Anogramma	Vascular cryptogams (Pteridophytes)
Solanum cf. nigrum-type	Herbs
Genistoideae-type	Trees and shrubs
Mercurialis cf. ovata	Herbs
Geranium reticulate-type	Herbs
Geranium striate-type	Herbs
Juniperus communis-type	Trees and shrubs
Rumex acetosa/R. scutatus-type	Herbs
Picea excelsa-type	Trees and shrubs
Botrychium cf. B. lunaria	Vascular cryptogams (Pteridophytes)
Genista-group	Trees and shrubs
Lauraceae	Trees and shrubs
cf. Salix polaris	Trees and shrubs
cf. Cornus mas	Indeterminables and unknowns
cf. Zelkova	Indeterminables and unknowns
cf. Ephedra	Indeterminables and unknowns
Selaginella cf. denticula	Vascular cryptogams (Pteridophytes)
Heracleum sp.	Herbs
Cardamine hirsuta-type	Herbs
Scabiosa graminifolia	Herbs
cf. Cynoglossum	Indeterminables and unknowns
Helianthemum/Cistus-type	Herbs
Rhamnus cathartica/R. alaternus-type	Trees and shrubs
cf. Plumbago	Indeterminables and unknowns
Cistus cf. C. monspeliensis	Trees and shrubs
Empetrum/Ledum-type	Dwarf shrubs
Rhamnus subg. Frangula	Trees and shrubs
Ranunculus ficaria-type	Herbs
Tofieldia-type	Herbs
Pinus haplostellate	Trees and shrubs
Alternanthera	Herbs
Azolla/Salvinia spore(s)	Aquatic Pteridophyta
Concentricystes circulus	Algae
cf. Scheuchzeria	Indeterminables and unknowns
Atriplex portulacoides	Herbs
Sphagnum imbricatum: leaves	Macrofossils
Cephalodella	Rotifera (Rotifers)
Halophytes	Indeterminables and unknowns
Poaceae Tardiglaciaire	Herbs
Pinus uncinata-type	Trees and shrubs
Coryloide-type	Trees and shrubs
Selaginella-type	Vascular cryptogams (Pteridophytes)
Phyteuma spicatum	Herbs
Centaurium sp.	Herbs
Zea mays-type	Herbs
Drosera longifolia	Herbs
Pseudotsuga douglasii	Trees and shrubs
Daphne laureola	Dwarf shrubs
Phytolacca	Herbs
Poaceae: clumps	Herbs
Capsella bursa-pastoris-type	Herbs
Filipendula vulgaris-type	Herbs
Succisa pratensis-type	Herbs
Valerianella-type	Herbs
Viola sp.	Herbs
Lythrum sp.	Herbs
Asteraceae subf. Cichorioideae	Herbs
Microspheres suspension (added)	Nonpollen
Microspheres (counted)	Nonpollen
Monolete psilate undiff.	Indeterminables and unknowns
Monolete spore(s) unknown	Vascular cryptogams (Pteridophytes)
Trilete spore(s) unknown	Vascular cryptogams (Pteridophytes)
Pteropyrum/Calligonum-type	Trees and shrubs
Salvadoraceae	Trees and shrubs
Commiphora	Trees and shrubs
Riella	Bryophytes
Deciduous tree: seed	Macrofossils
Indeterminable: triporate	Indeterminables and unknowns
Gramineae >42µm	Herbs
Macrocharcoal	Charcoal
Type 9	Undifferentiated NPP
Type 12	Fungi
Type 14	Fungi
Type 15	Fungi
Type 58	Algae
Pteropsida monolete	Vascular cryptogams (Pteridophytes)
Poaceae >37µm	Herbs
Betula pubescens-type: clumps	Trees and shrubs
Hippophae rhamnoides: clumps	Trees and shrubs
Apiaceae undiff.: clumps	Herbs
Cyperaceae: clumps	Helophytes
Exotics (counted)	Nonpollen
Number of exotics per tablet	Nonpollen
Volume of sample (mm3)	Nonpollen
Tablets (added)	Nonpollen
Quercus pedunculata	Trees and shrubs
Quercus sessiliflora	Trees and shrubs
Hydrophyta	Nonpollen
Ulex/Sarothamnus-type	Herbs
Comarum/Potentilla-type	Herbs
cf. Buxus	Indeterminables and unknowns
cf. Teucrium	Indeterminables and unknowns
Urtica atrovirens-type	Herbs
Evax-type	Herbs
Potentilla recta-type	Herbs
Potentilla erecta-type	Herbs
Lotus alpinus-type	Herbs
Trifolium campestre-type	Herbs
Atrichum spores	Bryophytes
Paeoniaceae	Herbs
Paeonia	Herbs
Pinus montana	Trees and shrubs
Erica mediterranea	Dwarf shrubs
Echinidinium transparantum	Dinoflagellates
Spiniferites mirabilis	Dinoflagellates
Brigantedinium	Dinoflagellates
Polykrikos kofoidii	Dinoflagellates
Peridinium ponticum	Dinoflagellates
Micrhystridium ariakense	Dinoflagellates
Protoperidinium stellatum	Dinoflagellates
Quinquecuspis concreta	Dinoflagellates
Cymatiosphaera globulosa	Acritarchs
Islandinium minutum	Dinoflagellates
Spiniferites belerius	Dinoflagellates
Dryopteris/Thelypteris	Vascular cryptogams (Pteridophytes)
Type 502	Fungi
Type 52D	Undifferentiated NPP
Type 25	Fungi
Pentaphrasodinium dalei	Dinoflagellates
Lingulodinium machaerophorum var. clavatum	Dinoflagellates
Anthericum liliago	Herbs
Campanula medium	Herbs
Coriandrum sativum	Herbs
Cucumis sativus	Herbs
Rhus-group	Trees and shrubs
Hedera: stomata	Vegetative microfossils
Nymphaeaceae: base cells	Vegetative microfossils
Saccharomyces	Fungi
cf. Sinapis	Herbs
Viola-type	Herbs
cf. Melampyrum	Indeterminables and unknowns
cf. Stachys sylvatica	Herbs
cf. Scilla/Fritillaria	Herbs
Plantago subulata subsp. insularis	Herbs
Leptosporangiatae	Vascular cryptogams (Pteridophytes)
Micranthes stellaris	Herbs
Micranthes stellaris-type	Herbs
Cryosophila	Herbs
Sphaerostephanos	Vascular cryptogams (Pteridophytes)
Mimulus	Herbs
Typha angustata	Helophytes
Tsuga heterophylla	Trees and shrubs
Athyrium undiff.	Vascular cryptogams (Pteridophytes)
Gentianaceae cf. Gentianella	Herbs
Trichomanes	Vascular cryptogams (Pteridophytes)
Pollen sums	Nonpollen
Fabaceae subf. Faboideae	Herbs
Cryptogramma-type	Vascular cryptogams (Pteridophytes)
Dryopteris-type undiff.	Vascular cryptogams (Pteridophytes)
Saxifragaceae-type	Herbs
Chamaenerion latifolium	Herbs
Diphasiastrum alpinum/D. complanatum	Vascular cryptogams (Pteridophytes)
Cistus hirsutuS	Herbs
Ferula glauca	Herbs
Dalechampia	Herbs
Calceolaria	Herbs
Davallia	Vascular cryptogams (Pteridophytes)
Araceae subf. Lemnoideae	Aquatics
Myriophyllum sibiricum-type	Aquatics
Dennstaedtia	Vascular cryptogams (Pteridophytes)
Iva	Herbs
cf. Corydalis claviculata	Herbs
cf. Hornungia-type	Herbs
Astragalus danicus	Herbs
cf. Vicia-type	Herbs
Chamaenerion-type	Herbs
Asteraceae subf. Carduoideae	Herbs
Bryonia cretica	Herbs
Persicaria bistorta-type	Herbs
Paris quadrifolia-type	Herbs
Gladiolus illyricus-type	Herbs
Lactuceae undiff.	Herbs
Poaceae annulus 8-10µm	Herbs
Poaceae annulus >10µm	Herbs
Poaceae <32µm	Herbs
Poaceae >32µm	Herbs
Plumbaginaceae undiff.	Herbs
Fern: sporangia	Vegetative microfossils
cf. Hippophae	Indeterminables and unknowns
cf. Verbascum	Indeterminables and unknowns
cf. Lamiaceae	Indeterminables and unknowns
cf. Carpinus-type	Indeterminables and unknowns
cf. Fraxinus	Indeterminables and unknowns
cf. Adonis vernalis-type	Indeterminables and unknowns
cf. Plantago lanceolata-type	Herbs
cf. Portulaca oleracea	Indeterminables and unknowns
cf. Dryopteris filix-mas/D. cristata	Vascular cryptogams (Pteridophytes)
cf. Fabaceae undiff.	Indeterminables and unknowns
cf. Aconitum napellus-type	Indeterminables and unknowns
cf. Lotus-type	Indeterminables and unknowns
cf. Menyanthes trifoliata	Indeterminables and unknowns
cf. Oenanthe fistulosa-type	Indeterminables and unknowns
cf. Sinapis-type	Herbs
Sample volume	Nonpollen
cf. Crataegus-type	Trees and shrubs
cf. Myriophyllum	Indeterminables and unknowns
cf. Boraginaceae undiff.	Indeterminables and unknowns
cf. Trapa natans	Indeterminables and unknowns
cf. Liliaceae undiff.	Indeterminables and unknowns
cf. Gentianaceae undiff.	Indeterminables and unknowns
cf. Nyssa	Indeterminables and unknowns
cf. Cornus suecica-type	Indeterminables and unknowns
cf. Saxifraga stellaris-type	Indeterminables and unknowns
cf. Hypericum elodes	Indeterminables and unknowns
cf. Juglans	Indeterminables and unknowns
cf. Blechnum spicant	Vascular cryptogams (Pteridophytes)
cf. Cornus mas-type	Indeterminables and unknowns
cf. Digitalis purpurea-type	Indeterminables and unknowns
cf. Fumana-type	Indeterminables and unknowns
cf. Heracleum sphondyllium-type	Herbs
cf. Plantago maritima-type	Herbs
cf. Polypodium vulgare-type	Vascular cryptogams (Pteridophytes)
cf. Polystichum-type	Vascular cryptogams (Pteridophytes)
cf. Sanguisorba minor	Indeterminables and unknowns
cf. Seseli libanotis-type	Herbs
cf. Silene vulgaris-type	Herbs
cf. Apiaceae undiff.	Indeterminables and unknowns
cf. Caltha palustris-type	Indeterminables and unknowns
cf. Cerastium fontanum-group	Herbs
cf. Chaerophyllum hirsutum	Herbs
cf. Mentha-type	Herbs
cf. Menyanthes trifoliata-type	Indeterminables and unknowns
cf. Nymphaea alba-type	Indeterminables and unknowns
cf. Potamogeton-type	Indeterminables and unknowns
cf. Potentilla-type	Herbs
cf. Ranunculus acris-type	Indeterminables and unknowns
cf. Saxifraga oppositifolia-type	Indeterminables and unknowns
cf. Scrophularia-type	Indeterminables and unknowns
cf. Scutellaria-type	Herbs
cf. Selaginella selaginoides	Indeterminables and unknowns
cf. Solanum dulcamara-type	Indeterminables and unknowns
cf. Trifolium-type	Herbs
cf. Valeriana dioica-type	Indeterminables and unknowns
cf. Acer campestre-type	Indeterminables and unknowns
cf. Carya-type	Indeterminables and unknowns
cf. Fagus	Indeterminables and unknowns
cf. Ilex-type	Indeterminables and unknowns
cf. Liquidambar styraciflua	Indeterminables and unknowns
cf. Pterocarya fraxinifolia-type	Indeterminables and unknowns
cf. Rhus typhina	Indeterminables and unknowns
cf. Ribes rubrum-type	Indeterminables and unknowns
cf. Sambucus nigra-type	Indeterminables and unknowns
cf. Tsuga	Trees and shrubs
Pterocarya fraxinifolia-type	Trees and shrubs
Avena/Triticum-group	Herbs
Phegopteris connectilis	Vascular cryptogams (Pteridophytes)
Rumex acetosa-group	Herbs
Sagina apetala-type	Herbs
Vaccinium-group	Dwarf shrubs
Apium inundatum/Trinia glauca-type	Herbs
Carum verticillatum-type	Herbs
Cicuta virosa-type	Herbs
Cirsium/Serratula-type	Herbs
Helicoon	Fungi
Hordeum-group	Herbs
Narthecium/Fritillaria/Scilla-type	Herbs
Pediastrum boryanum-type	Algae
Sagina procumbens-type	Herbs
Silene pratensis-type	Herbs
Arenaria montana	Herbs
Selaginella selaginoides: tetrads	Vascular cryptogams (Pteridophytes)
Pediastrum duplex-type	Algae
Betula pubescens undiff.	Trees and shrubs
Liquidambar styraciflua	Trees and shrubs
Laserpitium prutenicum-type	Herbs
Illecebrum verticillatum-type	Herbs
Lychnis coronaria-type	Herbs
Meum athamanticum/Angelica palustris-type	Herbs
Minuartia hybrida-type	Herbs
Oenanthe aquatica-group	Herbs
Rumex aquaticus-group	Herbs
Rumex conglomeratus-group	Herbs
Silene nutans-group	Herbs
Sparganium minimum-group	Helophytes
Gloeocapsa	Cyanobacteria
Betula pubescens-type/Betula undiff.	Trees and shrubs
Parietaria-type	Herbs
Cirsium/Serratula	Herbs
Sison amomum-type	Herbs
Aster/Anthemis/Cirsium/Serratula-type	Herbs
Urtica dioica-group	Herbs
Polygonum aviculare-group	Herbs
Lemna-type	Aquatics
Alisma plantago-aquatica-group	Herbs
Lythrum portula/L. salicaria	Herbs
Laser trilobum-type	Herbs
Pimpinella anisum-type	Herbs
Anthemis/Aster/Cirsium/Serratula	Herbs
Zopfiella lundqvistii	Fungi
Valeriana cf. sambucifolia	Herbs
Dryopteris sp.	Vascular cryptogams (Pteridophytes)
Bisaccate undiff.	Trees and shrubs
Armeria maritima/Limonium vulgare	Herbs
Bupleurum falcatum-group	Herbs
Crithmum maritimum-type	Herbs
Anagallis tenella/A. minima	Herbs
Anthemis/Aster-type	Herbs
Chaerophyllum bulbosum-type	Herbs
Parnassia palustris-type	Herbs
Betuloid-type	Trees and shrubs
Valerianella locusta-type	Herbs
cf. Trichomanes speciosum	Indeterminables and unknowns
Salix: clumps	Herbs
Moss spores	Bryophytes
Sagina procumbens-group	Herbs
Fagus: clumps	Trees and shrubs
cf. Hordeum-group	Herbs
cf. Ononis-type	Indeterminables and unknowns
cf. Pistacia	Indeterminables and unknowns
cf. Melampyrum: clumps	Indeterminables and unknowns
Pinus diploxylon-type: clumps	Trees and shrubs
Osmunda regalis: clumps	Vascular cryptogams (Pteridophytes)
cf. Juniperus-type: clumps	Indeterminables and unknowns
Anthemis-type: clumps	Herbs
Cerastium fontanum-group: clumps	Herbs
Chaerophyllum temulentum-type	Herbs
Indeterminata: clumps	Indeterminables and unknowns
Coryloide-type: clumps	Trees and shrubs
Carpinus betulus/Ostrya-type	Trees and shrubs
cf. Carya	Indeterminables and unknowns
cf. Pterocarya fraxinifolia	Indeterminables and unknowns
Arum	Herbs
Dipsacus/Cephalaria	Herbs
Liliaceae sensu lato	Herbs
cf. Plantago	Indeterminables and unknowns
cf. Ranunculaceae	Indeterminables and unknowns
Ranunculus lanuginosus-type	Herbs
Rhinanthus-group	Herbs
Indeterminable: immature	Indeterminables and unknowns
Lycopodiella-type	Vascular cryptogams (Pteridophytes)
Selaginella willdenowii	Vascular cryptogams (Pteridophytes)
Persicaria maculosa	Herbs
Spirogyra (psilate)	Vascular cryptogams (Pteridophytes)
Type 341B	Algae
Amphisphaerella dispersella	Vascular cryptogams (Pteridophytes)
Byssothecium circinans	Fungi
cf. Conochilus hippocrepis	Rotifera (Rotifers)
Epicoccum purpurascens	Fungi
Lycopodium suspension	Nonpollen
Spheroidal carbonaceous particle	Nonpollen
Morus alba-type	Trees and shrubs
Amaranthus	Herbs
Ranunculus aconitifolius-type	Herbs
Myrtus-type	Trees and shrubs
Chamaerops humilis	Trees and shrubs
Smyrnium	Herbs
Trachycarpus fortunei	Trees and shrubs
Anemone hortensis-type	Herbs
Fedia cornucopiae	Herbs
Gypsophila arrostii	Herbs
Rumex scutatus-type	Herbs
Saxifraga tridactylitis-type	Herbs
Simethis planifolia	Herbs
Smyrnium-type	Herbs
Urtica membranacea-type	Herbs
Phillyrea angustifolia-type	Trees and shrubs
Echium vulgare-type	Herbs
Corrigiola litoralis-type	Herbs
Corrigiola telephiifolia-type	Herbs
Erodium cicutarium-type	Herbs
Limonium humile-type	Herbs
Pinguicula vulgaris-type	Herbs
Circaea lutetiana-type	Herbs
Geranium molle-type	Herbs
Tilia: corroded	Trees and shrubs
cf. Botrychium	Vascular cryptogams (Pteridophytes)
cf. Lycopodium alpinum	Vascular cryptogams (Pteridophytes)
Rhamnus frangula	Trees and shrubs
Damasonium alisma	Herbs
Caldesia	Herbs
Cystopteris sudetica	Vascular cryptogams (Pteridophytes)
Thelycrania cf. sanguinea	Trees and shrubs
Eurotia ceratoides	Herbs
Alnaster fruticosus	Trees and shrubs
Charcoal <40µm	Charcoal
Charcoal >40µm	Charcoal
Cerealia-type cf. Avena/Triticum-group	Herbs
Cerealia-type cf. Hordeum-group	Herbs
Cerealia-type undiff.	Herbs
Hypericum cf. H. elodes	Herbs
Phryganella	Rhizopods
Hydrachnidia	Invertebrates
Olpidiaceae	Fungi
Uredinales	Fungi
Comandra elegans	Herbs
Logfia-type	Herbs
Delphinium elatum	Herbs
Lychnis alpina-type	Herbs
Lycopodium annotinum/L. alpinum	Vascular cryptogams (Pteridophytes)
Paronychia/Herniaria-type	Herbs
Polygonaceae non-Rumex	Herbs
Ranunculaceae cf. Anemone/Caltha	Herbs
Athyrium filix-femina-type	Vascular cryptogams (Pteridophytes)
Gymnocarpium-type	Vascular cryptogams (Pteridophytes)
Polypodium/Isoetes	Vascular cryptogams (Pteridophytes)
cf. Cathaya	Indeterminables and unknowns
Parrotia cf. persica	Trees and shrubs
Cladium mariscus-type	Helophytes
Gentianaceae-type	Herbs
Thelypteris cf. palustris-type	Vascular cryptogams (Pteridophytes)
Selaginella sibirica-type	Vascular cryptogams (Pteridophytes)
Taxaceae	Trees and shrubs
Taxodium-type	Trees and shrubs
Hippophae cf. rhamnoides	Trees and shrubs
Viscum cf. album	Trees and shrubs
cf. Trifolium	Herbs
Sanguisorba cf. minor	Vascular cryptogams (Pteridophytes)
Cladium cf. mariscus	Helophytes
Thelypteris cf. palustris	Vascular cryptogams (Pteridophytes)
Polypodium cf. vulgare	Vascular cryptogams (Pteridophytes)
Selaginella cf. selaginoides	Vascular cryptogams (Pteridophytes)
cf. Rhododendron	Dwarf shrubs
Pachysandra/Sarcococca	Trees and shrubs
Vigna-type	Herbs
Centranthus ruber	Trees and shrubs
Passifloraceae	Trees and shrubs
Typha cf. latifolia	Trees and shrubs
cf. Keteeleria	Trees and shrubs
Dryopteris cf. filix-mas	Vascular cryptogams (Pteridophytes)
cf. Erodium	Indeterminables and unknowns
Helicosporium	Fungi
Selaginella cf. sibirica	Vascular cryptogams (Pteridophytes)
Hippophae rhamnoides-type	Trees and shrubs
Cardamine pratensis	Herbs
Allium ursinum	Herbs
Pinus haplostellate-type	Trees and shrubs
Heliotropium europaeum-type	Herbs
Hypericum elodes-type	Herbs
Pedicularis sylvatica-type	Herbs
Ophioglossum-type	Vascular cryptogams (Pteridophytes)
cf. Acanthaceae	Indeterminables and unknowns
Anemone coronaria-type	Herbs
Capsicum-type	Herbs
cf. Gentianella-type	Herbs
Ranunculus parviflorus	Herbs
Bryophyta sensu lato	Bryophytes
Palynomorpha undiff.	Indeterminables and unknowns
Quercus ithaburensis-type	Trees and shrubs
Quercus calliprinos-type	Trees and shrubs
Phoenix	Trees and shrubs
cf. Saxifraga	Indeterminables and unknowns
Echium/Vincetoxicum	Indeterminables and unknowns
Symphytum/Cerinthe-type	Herbs
cf. Hystrichosphaerids	Dinoflagellates
cf. Ostrya	Indeterminables and unknowns
Cystopteris montana	Vascular cryptogams (Pteridophytes)
cf. Hottonia-type	Indeterminables and unknowns
cf. Parietaria	Indeterminables and unknowns
cf. Torilis arvensis	Herbs
cf. Jasione	Herbs
cf. Solanum	Indeterminables and unknowns
cf. Helleborus viridis	Herbs
cf. Sempervivum	Herbs
cf. Cicendia filiformis	Herbs
cf. Bupleurum	Herbs
Valeriana exaltata-type	Herbs
Torilis-type	Herbs
Anthericum cf. liliago	Herbs
Oxytropis-type	Herbs
Gentiana cf. purpurea	Herbs
Gymnocarpium robertianum	Vascular cryptogams (Pteridophytes)
Echium/Vincetoxicum-type	Indeterminables and unknowns
Gentiana bavarica	Herbs
Gentiana bavarica-type	Herbs
Lilium cf. martagon	Herbs
Onobrychis montana	Herbs
cf. Bunias	Herbs
cf. Melandrium	Herbs
cf. Muscari	Herbs
cf. Verbascum-type	Indeterminables and unknowns
cf. Athyrium alpestre	Vascular cryptogams (Pteridophytes)
cf. Muscari-type	Herbs
cf. Lychnis-type	Herbs
cf. Lysimachia	Indeterminables and unknowns
cf. Gagea-type	Herbs
Plantago montana/P. media	Herbs
Sarcopoterium-type	Trees and shrubs
Aquatic vascular plants	Aquatics
NPP undiff.	Undifferentiated NPP
Pinus cembra: stomata	Vegetative microfossils
Menyanthes: hairs	Vegetative microfossils
cf. Anthoceros	Indeterminables and unknowns
Poaceae: anther	Macrofossils
Corylus: anther	Macrofossils
Pinnularia cardinalis	Algae
Dryopteris austriaca subsp. spinulosa	Vascular cryptogams (Pteridophytes)
Plantago maritima/P. media	Herbs
Cyperaceae: rootlets	Macrofossils
cf. Hippuris	Indeterminables and unknowns
Cyperaceae: anther	Macrofossils
Betula: anther	Macrofossils
cf. Difflugia	Rhizopods
Betula: vessels	Vegetative microfossils
Alnus: perforation plates	Vegetative microfossils
Alnus: vessels	Vegetative microfossils
cf. Lemna	Indeterminables and unknowns
cf. Ruppia	Indeterminables and unknowns
cf. Stratiotes	Indeterminables and unknowns
Juncus bufonius: seed	Macrofossils
Sphagnum: leaf remains	Vegetative microfossils
Calluna: anther	Macrofossils
Corylus: wood	Macrofossils
Cerealia 37-40µm	Herbs
Cerealia 40-50µm	Herbs
Cerealia >50µm	Herbs
Lysimachia cf. thyrsiflora	Herbs
Eucalyptus tablets	Nonpollen
Linum cf. L. usitatissimum	Herbs
cf. Pisum	Herbs
Vicia cf. V. faba	Herbs
cf. Anemone-type	Indeterminables and unknowns
Eucalyptus (grains/g of tablet)	Nonpollen
Eucalyptus (spike)	Nonpollen
Rubus cf. R. saxatilis	Trees and shrubs
Ericaceae cf. Cassiope	Dwarf shrubs
Drosera anglica-type	Helophytes
Saxifraga nivalis/S. tenuis	Herbs
Betula tortuosa-type	Trees and shrubs
Aconitum septentrionale	Herbs
cf. Galeopsis	Indeterminables and unknowns
cf. Elatine	Indeterminables and unknowns
Rumex sect. Acetosa	Herbs
Poaceae annulus <8µm	Herbs
Poaceae annulus >8µm	Herbs
Lingulodinium cf. L. machaerophorum	Dinoflagellates
Operculodinium cf. O. centrocarpum	Dinoflagellates
Spiniferites	Dinoflagellates
cf. Limosella aquatica	Indeterminables and unknowns
cf. Maianthemum	Indeterminables and unknowns
Solidago-type/Saussurea-type	Herbs
Nuphar-type	Aquatics
cf. Sphagnum	Indeterminables and unknowns
Triticum spelta-type	Herbs
Secale, primitive	Herbs
Bosmina	Microcrustaceans
Bullinula indica	Rhizopods
Clathrulina elegans	Rhizopods
Difflugia pyriformis	Rhizopods
Erica ciliaris	Dwarf shrubs
Nebela collaris	Rhizopods
Phryganella hemisphaerica	Rhizopods
Simocephalus	Microcrustaceans
cf. Rhamnus	Indeterminables and unknowns
Phacotus lenticularis	Algae
Charcoal >45µm	Charcoal
Ribes undiff.	Trees and shrubs
Ribes alpinum-type	Trees and shrubs
Forsythia	Trees and shrubs
cf. Urtica pilulifera	Indeterminables and unknowns
Quercus faginea-type	Trees and shrubs
Bupleurum rigidum-type	Herbs
Lithodora fruticosa-type	Trees and shrubs
Corrigiola telephiifolia	Herbs
Type TM-M2	Fungi
Type TM-4036	Fungi
Type TM-4004	Fungi
Type TM-037	Fungi
Type TM-316	Fungi
Type TM-510	Fungi
Type TM-523	Fungi
Type TM-362	Fungi
Type TM-524	Fungi
Marchantia: thallus remains	Macrofossils
Type HdV-44	Fungi
Type HdV-572	Fungi
Type HdV-201	Fungi
Type HdV-8	Fungi
Type HdV-77	Fungi
Type HdV-16	Fungi
Type HdV-729	Fungi
Type HdV-18	Fungi
Type HdV-546	Fungi
Type HdV-569	Fungi
Scleroderma	Fungi
Peridinium	Dinoflagellates
